0 0 0 0 0 0 0 0 0 0 0 0 0 0 0 0 0 0 0 0 0 0 0 0 0 0 0 0 0 0 0 0 0 0 0 0 0 0 0 0 0 0 0 0 0 0 0 0 0 0 0 0 0 0 0 0 0 0 0 0 0 0 0 0 0 0 0 0 0 0 0 0 0 0 0 0 0 0 0 0 
0 1 1 1 1 1 1 1 1 1 1 1 1 1 1 1 1 1 1 1 1 1 1 1 1 1 1 1 1 1 1 1 1 1 1 1 1 1 1 1 1 1 1 1 1 1 1 1 1 1 1 1 1 1 1 1 1 1 1 1 1 1 1 1 1 1 1 1 1 1 1 1 1 1 1 1 1 1 1 0 
0 1 1 1 1 1 1 1 1 1 1 1 1 1 1 1 1 1 1 1 1 1 1 1 1 1 1 1 1 1 1 1 1 1 1 1 1 1 1 1 1 1 1 1 1 1 1 1 1 1 1 1 1 1 1 1 1 1 1 1 1 1 1 1 1 1 1 1 1 1 1 1 1 1 1 1 1 1 1 0 
0 1 1 1 1 1 1 1 1 1 1 1 1 1 1 1 1 1 1 1 1 1 1 1 1 1 1 1 1 1 1 1 1 1 1 1 1 1 1 1 1 1 1 1 1 1 1 1 1 1 1 1 1 1 1 1 1 1 1 1 1 1 1 1 1 1 1 1 1 1 1 1 1 1 1 1 1 1 1 0 
0 1 1 1 1 2 2 2 2 2 2 2 2 2 1 1 1 1 1 1 1 1 1 1 1 1 1 1 1 1 1 1 1 1 2 2 2 2 2 2 2 2 2 2 1 1 1 1 1 1 1 2 2 2 2 2 2 2 2 2 2 2 2 2 2 2 2 2 2 2 2 2 2 1 1 1 1 1 1 0 
0 1 1 1 1 2 11 11 11 11 11 6 6 2 1 1 1 1 1 2 2 2 2 2 2 2 2 2 2 1 1 1 1 1 2 11 11 11 11 11 7 7 6 2 1 1 1 1 1 1 1 2 18 4 4 4 4 4 4 4 4 4 2 6 11 11 10 10 10 11 11 11 2 1 1 1 1 1 1 0 
0 1 1 1 1 2 11 11 11 11 11 7 7 2 1 1 1 1 1 2 4 4 8 4 4 4 4 6 2 1 1 1 1 1 2 8 11 11 11 11 11 11 11 2 1 1 1 1 1 1 1 2 4 4 4 8 8 4 4 4 4 4 2 7 11 11 11 11 11 11 11 11 2 1 1 1 1 1 1 0 
0 1 1 1 1 2 8 11 11 11 11 7 7 2 1 1 1 1 1 2 4 9 9 9 4 4 4 7 2 1 1 1 1 1 2 9 9 11 11 11 11 11 11 2 1 1 1 1 1 1 1 2 4 4 9 9 9 9 4 4 4 4 2 7 11 11 11 11 11 11 11 11 2 1 3 3 3 3 1 0 
0 1 1 1 1 2 9 9 11 11 11 11 11 1 1 1 1 1 1 2 4 9 9 9 4 4 4 7 2 1 1 1 1 1 2 9 9 11 11 11 11 11 11 1 1 1 1 1 1 1 1 2 4 8 9 9 9 9 8 4 4 4 4 11 11 11 11 11 11 11 11 11 1 1 3 3 3 3 1 0 
0 1 1 1 1 2 9 9 11 11 11 11 11 1 1 1 1 1 1 2 4 9 9 9 4 4 4 4 2 1 1 1 1 1 2 9 9 11 11 11 11 11 11 1 1 1 1 1 1 1 1 2 4 8 9 9 9 9 8 4 4 4 4 11 11 11 11 11 11 11 11 11 1 1 3 3 3 3 1 0 
0 1 1 1 1 2 8 11 11 11 11 7 7 2 1 1 1 1 1 2 4 4 8 4 4 4 4 4 2 1 1 1 1 1 2 9 9 11 11 11 11 11 11 2 1 1 1 1 1 1 1 2 4 4 9 9 9 9 4 4 4 4 2 7 11 11 11 11 11 11 11 11 2 1 3 3 3 3 1 0 
0 1 1 1 1 2 11 11 11 11 11 7 7 2 1 1 1 1 1 2 4 4 4 4 4 7 7 6 2 1 1 1 1 1 2 8 11 11 11 11 11 11 11 2 1 1 1 1 1 1 1 2 4 4 4 8 8 4 4 4 4 4 2 7 11 11 11 11 11 11 11 11 2 1 1 1 1 1 1 0 
0 1 1 1 1 2 11 11 11 11 11 6 6 2 1 1 1 1 1 2 2 2 2 1 1 2 2 2 2 1 1 1 1 1 2 11 11 11 11 11 7 7 6 2 1 1 1 1 1 1 1 2 4 4 4 4 4 4 4 4 4 4 2 6 11 11 12 12 12 11 11 11 2 1 1 1 1 1 1 0 
0 1 1 1 1 2 2 2 2 2 2 2 2 2 1 1 1 1 1 1 1 1 1 1 1 1 1 1 1 1 1 1 1 1 2 2 2 2 2 2 2 2 2 2 1 1 1 1 1 1 1 2 2 2 2 2 2 2 2 2 2 2 2 2 2 2 2 2 2 2 2 2 2 1 1 1 1 1 1 0 
0 1 1 1 1 1 1 1 1 1 1 1 1 1 1 1 1 1 1 1 1 1 1 1 1 1 1 1 1 1 1 1 1 1 1 1 1 1 1 1 1 1 1 1 1 1 1 1 1 1 1 1 1 1 1 1 1 1 1 1 1 1 1 1 1 1 1 1 1 1 1 1 1 1 1 1 1 1 1 0 
0 1 1 1 1 1 1 1 1 1 1 1 1 1 1 1 1 1 1 1 1 1 1 1 1 1 1 1 1 1 1 1 1 1 1 1 1 1 1 1 1 1 1 1 1 1 1 1 1 1 1 1 1 1 1 1 1 1 1 1 1 1 1 1 1 1 1 1 1 1 1 1 1 1 1 1 1 1 1 0 
0 1 1 1 1 1 1 1 1 1 1 1 1 1 1 1 1 1 1 1 1 1 1 1 1 1 1 1 1 1 1 1 1 1 1 1 1 1 1 1 1 1 1 1 1 1 1 1 1 1 1 1 1 1 1 1 1 1 1 1 1 1 1 1 1 1 1 1 1 1 1 1 1 1 1 1 1 1 1 0 
0 1 1 1 1 1 1 1 1 1 1 1 1 1 1 1 1 1 2 2 2 2 2 2 2 2 2 2 2 2 1 1 1 1 1 1 1 1 1 1 1 1 1 1 1 1 1 1 1 1 1 1 1 1 1 1 1 1 1 1 1 1 1 1 1 1 1 1 1 1 1 1 1 1 1 1 1 1 1 0 
0 1 1 1 1 1 2 2 2 2 2 2 2 1 1 1 1 1 2 18 13 8 9 9 9 8 13 6 6 2 1 1 1 1 1 2 2 2 2 2 2 2 2 1 1 1 1 1 1 1 1 2 2 2 2 2 2 2 2 2 2 2 2 2 2 2 2 2 2 2 2 2 2 1 1 1 1 1 1 0 
0 1 1 1 1 1 2 18 4 7 7 6 2 1 1 1 1 1 2 13 13 13 9 9 9 13 13 7 7 2 1 1 1 1 1 2 6 13 13 13 10 10 2 1 1 1 1 1 1 1 1 2 11 11 11 11 11 11 11 11 11 11 2 6 4 4 10 10 10 4 4 8 2 1 1 1 1 1 1 0 
0 1 1 1 1 1 2 4 4 4 4 4 2 1 1 1 1 1 2 13 13 13 13 13 13 13 13 7 7 2 1 1 1 1 1 2 7 13 13 13 13 13 2 1 1 1 1 1 1 1 1 2 11 11 11 8 8 11 11 11 11 11 2 7 4 4 4 4 4 4 4 4 2 1 1 1 1 1 1 0 
0 1 1 1 1 1 1 4 4 4 4 4 2 1 1 1 1 1 1 13 13 13 13 13 13 13 13 13 13 2 1 1 1 1 1 2 7 13 13 13 13 13 2 1 1 1 1 1 1 1 1 2 11 11 9 9 9 9 11 11 11 11 2 7 4 4 4 4 4 4 4 4 2 1 1 1 1 1 1 0 
0 1 1 1 1 1 1 4 4 4 4 4 2 1 1 1 1 1 1 13 13 13 13 13 13 13 13 13 13 2 1 1 1 1 1 2 13 13 13 13 13 13 2 1 1 1 1 1 1 1 1 2 11 8 9 9 9 9 8 11 11 11 11 4 4 4 4 4 4 4 4 4 1 1 1 1 1 1 1 0 
0 1 1 1 1 1 2 4 4 4 4 4 2 1 1 1 1 1 2 13 13 13 13 13 13 13 13 7 7 2 1 1 1 1 1 2 13 13 13 13 13 8 2 1 1 1 1 1 1 1 1 2 11 8 9 9 9 9 8 11 11 11 11 4 4 4 4 4 4 4 4 4 1 1 1 1 1 1 1 0 
0 1 1 1 1 1 2 4 4 8 9 9 2 1 1 1 1 1 2 13 13 13 13 13 13 13 13 7 7 2 1 1 1 1 1 2 13 13 13 13 9 9 2 1 1 1 1 1 1 1 1 2 11 11 9 9 9 9 11 11 11 11 2 7 4 4 4 4 4 4 4 4 2 1 1 1 1 1 1 0 
0 1 1 1 1 1 2 2 2 2 2 2 2 1 1 1 1 1 2 13 13 13 12 12 12 13 13 6 6 2 1 1 1 1 1 2 2 2 1 1 2 2 2 1 1 1 1 1 1 1 1 2 11 11 11 8 8 11 11 11 11 11 2 7 4 4 4 4 4 4 4 4 2 1 1 1 1 1 1 0 
0 1 1 1 1 1 1 1 1 1 1 1 1 1 1 1 1 1 2 2 2 2 2 2 2 2 2 2 2 2 1 1 1 1 1 1 1 1 1 1 1 1 1 1 1 1 1 1 1 1 1 2 11 11 11 11 11 11 11 11 11 11 2 6 4 4 4 4 4 4 4 8 2 1 1 1 1 1 1 0 
0 1 1 1 1 1 1 1 1 1 1 1 1 1 1 1 1 1 1 1 1 1 1 1 1 1 1 1 1 1 1 1 1 1 1 1 1 1 1 1 1 1 1 1 1 1 1 1 1 1 1 2 2 2 2 2 2 2 2 2 2 2 2 2 2 2 2 2 2 2 2 2 2 1 1 1 1 1 1 0 
0 1 1 1 1 1 1 1 1 1 1 1 1 1 1 1 1 1 1 1 1 1 1 1 1 1 1 1 1 1 1 1 1 1 1 1 1 1 1 1 1 1 1 1 1 1 1 1 1 1 1 1 1 1 1 1 1 1 1 1 1 1 1 1 1 1 1 1 1 1 1 1 1 1 1 1 1 1 1 0 
0 1 1 1 1 1 1 1 1 1 1 1 1 1 1 1 1 1 1 1 1 1 1 1 1 1 1 1 1 1 1 1 1 1 1 1 1 1 1 1 1 1 1 1 1 1 1 1 1 1 1 1 1 1 1 1 1 1 1 1 1 1 1 1 1 1 1 1 1 1 1 1 1 1 1 1 1 1 1 0 
0 1 1 1 1 2 2 2 2 2 2 2 2 2 2 2 2 2 2 2 2 2 2 2 2 2 2 2 2 2 1 1 1 1 1 1 1 1 1 1 1 1 1 1 1 1 1 1 1 1 1 1 1 1 1 1 1 1 1 1 1 1 1 1 1 1 1 1 1 1 1 1 1 1 1 1 1 1 1 0 
0 1 1 1 1 2 13 13 13 13 13 13 13 13 13 13 2 6 7 7 11 11 11 11 8 9 9 9 8 2 1 1 1 1 1 1 1 1 1 1 1 1 1 1 1 1 1 1 1 1 1 1 1 1 1 1 1 1 1 1 1 1 1 1 1 1 1 1 1 1 1 1 1 1 1 1 1 1 1 0 
0 1 1 1 1 2 13 13 13 13 8 8 13 13 13 13 2 6 7 7 11 11 11 11 11 9 9 9 11 2 1 1 1 1 1 1 1 1 1 1 1 1 1 1 1 1 1 1 1 1 1 2 2 2 2 2 2 2 2 2 1 1 1 1 2 2 2 2 2 2 2 2 2 1 1 1 1 1 1 0 
0 1 1 1 1 2 13 13 13 9 9 9 9 13 13 13 2 11 11 11 11 11 11 11 11 11 11 11 11 2 1 1 1 1 1 1 1 1 1 1 1 1 1 1 1 1 1 1 1 1 1 2 18 8 9 9 9 8 6 2 1 1 1 1 2 6 13 10 10 10 13 18 2 1 1 1 1 1 1 0 
0 1 1 1 1 2 13 13 8 9 9 9 9 8 13 13 13 11 11 11 11 11 11 11 11 11 11 11 11 1 1 1 1 1 1 1 1 1 1 1 1 1 1 1 1 1 1 1 1 1 1 2 13 13 9 9 9 13 7 2 1 1 1 1 2 7 13 13 13 13 13 13 2 1 3 3 3 3 1 0 
0 1 1 1 1 2 13 13 8 9 9 9 9 8 13 13 13 11 11 11 11 11 11 11 11 11 11 11 11 1 1 1 1 1 1 1 1 1 1 1 1 1 1 1 1 1 1 1 1 1 1 13 13 13 13 13 13 13 7 2 1 1 1 1 2 7 13 13 13 13 13 13 13 1 3 3 3 3 1 0 
0 1 1 1 1 2 13 13 13 9 9 9 9 13 13 13 2 11 11 11 11 11 11 11 11 11 11 11 11 2 1 1 1 1 1 1 1 1 1 1 1 1 1 1 1 1 1 1 1 1 1 13 13 13 13 13 13 13 13 2 1 1 1 1 2 13 13 13 13 13 13 13 13 1 3 3 3 3 1 0 
0 1 1 1 1 2 13 13 13 13 8 8 13 13 13 13 2 6 7 7 11 11 11 11 11 11 11 11 11 2 1 1 1 1 1 1 3 3 3 3 3 3 3 3 3 1 1 1 1 1 1 2 13 13 13 13 13 13 13 2 1 1 1 1 2 13 13 9 9 9 13 13 2 1 3 3 3 3 1 0 
0 1 1 1 1 2 13 13 13 13 13 13 13 13 13 13 2 6 7 7 11 11 11 11 11 12 12 12 11 2 1 1 1 1 1 1 3 3 3 3 3 3 3 3 3 1 1 1 1 1 1 2 13 13 12 12 12 13 13 2 1 1 1 1 2 13 8 9 9 9 8 13 2 1 1 1 1 1 1 0 
0 0 0 0 0 0 0 0 0 0 0 0 0 0 0 0 0 0 0 0 0 0 0 0 0 0 0 0 0 0 0 0 0 0 0 0 0 0 0 0 0 0 0 0 0 0 0 0 0 0 0 0 0 0 0 0 0 0 0 0 0 0 0 0 0 0 0 0 0 0 0 0 0 0 0 0 0 0 0 0 
