0 0 0 0 0 0 0 0 0 0 0 0 0 0 0 0 0 0 0 0 0 0 0 0 0 0 0 0 0 0 0 0 0 0 0 0 0 0 0 0 0 0 0 0 0 0 0 0 0 0 0 0 0 0 0 0 0 0 0 0 0 0 0 0 0 0 0 0 0 0 0 0 0 0 0 0 0 0 0 0 
0 1 1 1 1 1 1 1 1 1 1 1 1 1 1 1 1 1 1 1 1 1 1 1 1 1 1 1 1 1 1 1 1 1 1 1 1 1 1 1 1 1 1 1 1 1 1 1 1 1 1 1 1 1 1 1 1 1 1 1 1 1 1 1 1 1 1 1 1 1 1 1 1 1 1 1 1 1 1 0 
0 1 1 1 1 1 1 1 1 1 1 1 1 1 1 1 1 1 1 1 1 1 1 1 1 1 1 1 1 1 1 1 1 1 1 1 1 1 1 1 1 1 1 1 1 1 1 1 1 1 1 1 1 1 1 1 1 1 1 1 1 1 1 1 1 1 1 1 1 1 1 1 1 1 1 1 1 1 1 0 
0 1 1 1 1 1 1 1 1 1 1 1 1 1 1 1 1 1 1 1 1 1 1 1 1 1 1 1 1 1 1 1 1 1 1 1 1 1 1 1 1 1 1 1 1 1 1 1 1 1 1 1 1 1 1 1 1 1 1 1 1 1 1 1 1 1 1 1 1 1 1 1 1 1 1 1 1 1 1 0 
0 1 1 1 1 2 2 2 2 2 2 2 2 2 1 1 1 1 1 1 1 1 1 1 1 1 1 1 1 1 1 1 1 1 2 2 2 2 2 2 2 2 2 2 1 1 1 1 1 1 1 2 2 2 2 2 2 2 2 2 2 2 2 2 2 2 2 2 2 2 2 2 2 1 1 1 1 1 1 0 
0 1 1 1 1 2 4 4 4 4 4 6 6 2 1 1 1 1 1 2 2 2 2 2 2 2 2 2 2 1 1 1 1 1 2 4 4 4 4 4 7 7 6 2 1 1 1 1 1 1 1 2 18 4 4 4 4 4 4 4 4 4 2 6 4 4 4 4 4 4 4 4 2 1 1 1 1 1 1 0 
0 1 1 1 1 2 4 4 4 4 4 7 7 2 1 1 1 1 1 2 4 4 8 4 4 4 4 6 2 1 1 1 1 1 2 8 4 4 4 4 4 4 4 2 1 1 1 1 1 1 1 2 4 4 4 8 8 4 4 4 4 4 2 7 4 4 4 4 4 4 4 4 2 1 1 1 1 1 1 0 
0 1 1 1 1 2 8 4 4 4 4 7 7 2 1 1 1 1 1 2 4 9 9 9 4 4 4 7 2 1 1 1 1 1 2 9 9 4 4 4 4 4 4 2 1 1 1 1 1 1 1 2 4 4 9 9 9 9 4 4 4 4 2 7 4 4 4 4 4 4 4 4 2 1 3 3 3 3 1 0 
0 1 1 1 1 2 9 9 4 4 4 4 4 1 1 1 1 1 1 2 4 9 9 9 4 4 4 7 2 1 1 1 1 1 2 9 9 4 4 4 4 4 4 1 1 1 1 1 1 1 1 2 4 8 9 9 9 9 8 4 4 4 4 4 4 4 4 4 4 4 4 4 1 1 3 3 3 3 1 0 
0 1 1 1 1 2 9 9 4 4 4 4 4 1 1 1 1 1 1 2 4 9 9 9 4 4 4 4 2 1 1 1 1 1 2 9 9 4 4 4 4 4 4 1 1 1 1 1 1 1 1 2 4 8 9 9 9 9 8 4 4 4 4 4 4 4 4 4 4 4 4 4 1 1 3 3 3 3 1 0 
0 1 1 1 1 2 8 4 4 4 4 7 7 2 1 1 1 1 1 2 4 4 8 4 4 4 4 4 2 1 1 1 1 1 2 9 9 4 4 4 4 4 4 2 1 1 1 1 1 1 1 2 4 4 9 9 9 9 4 4 4 4 2 7 4 4 4 4 4 4 4 4 2 1 3 3 3 3 1 0 
0 1 1 1 1 2 4 4 4 4 4 7 7 2 1 1 1 1 1 2 4 4 4 4 4 7 7 6 2 1 1 1 1 1 2 8 4 4 4 4 4 4 4 2 1 1 1 1 1 1 1 2 4 4 4 8 8 4 4 4 4 4 2 7 4 4 4 4 4 4 4 4 2 1 1 1 1 1 1 0 
0 1 1 1 1 2 4 4 4 4 4 6 6 2 1 1 1 1 1 2 2 2 2 1 1 2 2 2 2 1 1 1 1 1 2 4 4 4 4 4 7 7 6 2 1 1 1 1 1 1 1 2 4 4 4 4 4 4 4 4 4 4 2 6 4 4 4 4 4 4 4 4 2 1 1 1 1 1 1 0 
0 1 1 1 1 2 2 2 2 2 2 2 2 2 1 1 1 1 1 1 1 1 1 1 1 1 1 1 1 1 1 1 1 1 2 2 2 2 2 2 2 2 2 2 1 1 1 1 1 1 1 2 2 2 2 2 2 2 2 2 2 2 2 2 2 2 2 2 2 2 2 2 2 1 1 1 1 1 1 0 
0 1 1 1 1 1 1 1 1 1 1 1 1 1 1 1 1 1 1 1 1 1 1 1 1 1 1 1 1 1 1 1 1 1 1 1 1 1 1 1 1 1 1 1 1 1 1 1 1 1 1 1 1 1 1 1 1 1 1 1 1 1 1 1 1 1 1 1 1 1 1 1 1 1 1 1 1 1 1 0 
0 1 1 1 1 1 1 1 1 1 1 1 1 1 1 1 1 1 1 1 1 1 1 1 1 1 1 1 1 1 1 1 1 1 1 1 1 1 1 1 1 1 1 1 1 1 1 1 1 1 1 1 1 1 1 1 1 1 1 1 1 1 1 1 1 1 1 1 1 1 1 1 1 1 1 1 1 1 1 0 
0 1 1 1 1 1 1 1 1 1 1 1 1 1 1 1 1 1 1 1 1 1 1 1 1 1 1 1 1 1 1 1 1 1 1 1 1 1 1 1 1 1 1 1 1 1 1 1 1 1 1 1 1 1 1 1 1 1 1 1 1 1 1 1 1 1 1 1 1 1 1 1 1 1 1 1 1 1 1 0 
0 1 1 1 1 1 1 1 1 1 1 1 1 1 1 1 1 1 2 2 2 2 2 2 2 2 2 2 2 2 1 1 1 1 1 1 1 1 1 1 1 1 1 1 1 1 1 1 1 1 1 1 1 1 1 1 1 1 1 1 1 1 1 1 1 1 1 1 1 1 1 1 1 1 1 1 1 1 1 0 
0 1 1 1 1 1 2 2 2 2 2 2 2 1 1 1 1 1 2 18 4 8 9 9 9 8 4 6 6 2 1 1 1 1 1 2 2 2 2 2 2 2 2 1 1 1 1 1 1 1 1 2 2 2 2 2 2 2 2 2 2 2 2 2 2 2 2 2 2 2 2 2 2 1 1 1 1 1 1 0 
0 1 1 1 1 1 2 18 4 7 7 6 2 1 1 1 1 1 2 4 4 4 9 9 9 4 4 7 7 2 1 1 1 1 1 2 6 4 4 4 10 10 2 1 1 1 1 1 1 1 1 2 4 4 4 4 4 4 4 4 4 4 2 6 4 4 10 10 10 4 4 8 2 1 1 1 1 1 1 0 
0 1 1 1 1 1 2 4 4 4 4 4 2 1 1 1 1 1 2 4 4 4 4 4 4 4 4 7 7 2 1 1 1 1 1 2 7 4 4 4 4 4 2 1 1 1 1 1 1 1 1 2 4 4 4 8 8 4 4 4 4 4 2 7 4 4 4 4 4 4 4 4 2 1 1 1 1 1 1 0 
0 1 1 1 1 1 1 4 4 4 4 4 2 1 1 1 1 1 1 4 4 4 4 4 4 4 4 4 4 2 1 1 1 1 1 2 7 4 4 4 4 4 2 1 1 1 1 1 1 1 1 2 4 4 9 9 9 9 4 4 4 4 2 7 4 4 4 4 4 4 4 4 2 1 1 1 1 1 1 0 
0 1 1 1 1 1 1 4 4 4 4 4 2 1 1 1 1 1 1 4 4 4 4 4 4 4 4 4 4 2 1 1 1 1 1 2 4 4 4 4 4 4 2 1 1 1 1 1 1 1 1 2 4 8 9 9 9 9 8 4 4 4 4 4 4 4 4 4 4 4 4 4 1 1 1 1 1 1 1 0 
0 1 1 1 1 1 2 4 4 4 4 4 2 1 1 1 1 1 2 4 4 4 4 4 4 4 4 7 7 2 1 1 1 1 1 2 4 4 4 4 4 8 2 1 1 1 1 1 1 1 1 2 4 8 9 9 9 9 8 4 4 4 4 4 4 4 4 4 4 4 4 4 1 1 1 1 1 1 1 0 
0 1 1 1 1 1 2 4 4 8 9 9 2 1 1 1 1 1 2 4 4 4 4 4 4 4 4 7 7 2 1 1 1 1 1 2 4 4 4 4 9 9 2 1 1 1 1 1 1 1 1 2 4 4 9 9 9 9 4 4 4 4 2 7 4 4 4 4 4 4 4 4 2 1 1 1 1 1 1 0 
0 1 1 1 1 1 2 2 2 2 2 2 2 1 1 1 1 1 2 4 4 4 12 12 12 4 4 6 6 2 1 1 1 1 1 2 2 2 1 1 2 2 2 1 1 1 1 1 1 1 1 2 4 4 4 8 8 4 4 4 4 4 2 7 4 4 4 4 4 4 4 4 2 1 1 1 1 1 1 0 
0 1 1 1 1 1 1 1 1 1 1 1 1 1 1 1 1 1 2 2 2 2 2 2 2 2 2 2 2 2 1 1 1 1 1 1 1 1 1 1 1 1 1 1 1 1 1 1 1 1 1 2 4 4 4 4 4 4 4 4 4 4 2 6 4 4 4 4 4 4 4 8 2 1 1 1 1 1 1 0 
0 1 1 1 1 1 1 1 1 1 1 1 1 1 1 1 1 1 1 1 1 1 1 1 1 1 1 1 1 1 1 1 1 1 1 1 1 1 1 1 1 1 1 1 1 1 1 1 1 1 1 2 2 2 2 2 2 2 2 2 2 2 2 2 2 2 2 2 2 2 2 2 2 1 1 1 1 1 1 0 
0 1 1 1 1 1 1 1 1 1 1 1 1 1 1 1 1 1 1 1 1 1 1 1 1 1 1 1 1 1 1 1 1 1 1 1 1 1 1 1 1 1 1 1 1 1 1 1 1 1 1 1 1 1 1 1 1 1 1 1 1 1 1 1 1 1 1 1 1 1 1 1 1 1 1 1 1 1 1 0 
0 1 1 1 1 1 1 1 1 1 1 1 1 1 1 1 1 1 1 1 1 1 1 1 1 1 1 1 1 1 1 1 1 1 1 1 1 1 1 1 1 1 1 1 1 1 1 1 1 1 1 1 1 1 1 1 1 1 1 1 1 1 1 1 1 1 1 1 1 1 1 1 1 1 1 1 1 1 1 0 
0 1 1 1 1 2 2 2 2 2 2 2 2 2 2 2 2 2 2 2 2 2 2 2 2 2 2 2 2 2 1 1 1 1 1 1 1 1 1 1 1 1 1 1 1 1 1 1 1 1 1 1 1 1 1 1 1 1 1 1 1 1 1 1 1 1 1 1 1 1 1 1 1 1 1 1 1 1 1 0 
0 1 1 1 1 2 18 4 4 4 4 4 4 4 4 4 2 6 7 7 4 4 4 4 8 9 9 9 8 2 1 1 1 1 1 1 1 1 1 1 1 1 1 1 1 1 1 1 1 1 1 1 1 1 1 1 1 1 1 1 1 1 1 1 1 1 1 1 1 1 1 1 1 1 1 1 1 1 1 0 
0 1 1 1 1 2 4 4 4 4 8 8 4 4 4 4 2 6 7 7 4 4 4 4 4 9 9 9 4 2 1 1 1 1 1 1 1 1 1 1 1 1 1 1 1 1 1 1 1 1 1 2 2 2 2 2 2 2 2 2 1 1 1 1 2 2 2 2 2 2 2 2 2 1 1 1 1 1 1 0 
0 1 1 1 1 2 4 4 4 9 9 9 9 4 4 4 2 4 4 4 4 4 4 4 4 4 4 4 4 2 1 1 1 1 1 1 1 1 1 1 1 1 1 1 1 1 1 1 1 1 1 2 18 8 9 9 9 8 6 2 1 1 1 1 2 6 4 10 10 10 4 18 2 1 1 1 1 1 1 0 
0 1 1 1 1 2 4 4 8 9 9 9 9 8 4 4 4 4 4 4 4 4 4 4 4 4 4 4 4 1 1 1 1 1 1 1 1 1 1 1 1 1 1 1 1 1 1 1 1 1 1 2 4 4 9 9 9 4 7 2 1 1 1 1 2 7 4 4 4 4 4 4 2 1 3 3 3 3 1 0 
0 1 1 1 1 2 4 4 8 9 9 9 9 8 4 4 4 4 4 4 4 4 4 4 4 4 4 4 4 1 1 1 1 1 1 1 1 1 1 1 1 1 1 1 1 1 1 1 1 1 1 4 4 4 4 4 4 4 7 2 1 1 1 1 2 7 4 4 4 4 4 4 4 1 3 3 3 3 1 0 
0 1 1 1 1 2 4 4 4 9 9 9 9 4 4 4 2 4 4 4 4 4 4 4 4 4 4 4 4 2 1 1 1 1 1 1 1 1 1 1 1 1 1 1 1 1 1 1 1 1 1 4 4 4 4 4 4 4 4 2 1 1 1 1 2 4 4 4 4 4 4 4 4 1 3 3 3 3 1 0 
0 1 1 1 1 2 4 4 4 4 8 8 4 4 4 4 2 6 7 7 4 4 4 4 4 4 4 4 4 2 1 1 1 1 1 1 3 3 3 3 3 3 3 3 3 1 1 1 1 1 1 2 4 4 4 4 4 4 4 2 1 1 1 1 2 4 4 9 9 9 4 4 2 1 3 3 3 3 1 0 
0 1 1 1 1 2 4 4 4 4 4 4 4 4 4 4 2 6 7 7 4 4 4 4 4 12 12 12 4 2 1 1 1 1 1 1 3 3 3 3 3 3 3 3 3 1 1 1 1 1 1 2 4 4 12 12 12 4 4 2 1 1 1 1 2 4 8 9 9 9 8 4 2 1 1 1 1 1 1 0 
0 0 0 0 0 0 0 0 0 0 0 0 0 0 0 0 0 0 0 0 0 0 0 0 0 0 0 0 0 0 0 0 0 0 0 0 0 0 0 0 0 0 0 0 0 0 0 0 0 0 0 0 0 0 0 0 0 0 0 0 0 0 0 0 0 0 0 0 0 0 0 0 0 0 0 0 0 0 0 0 
