0 0 0 0 0 0 0 0 0 0 0 0 0 0 0 0 0 0 0 0 0 0 0 0 0 0 0 0 0 0 0 0 0 0 0 0 0 0 0 0 0 0 0 0 0 0 0 0 0 0 0 0 0 0 0 0 0 0 0 0 0 0 0 0 0 0 0 0 0 0 0 0 0 0 0 0 0 0 0 0 
0 1 1 1 1 1 1 1 1 1 1 1 1 1 1 1 1 1 1 1 1 1 1 1 1 1 1 1 1 1 1 1 1 1 1 1 1 1 1 1 1 1 1 1 1 1 1 1 1 1 1 1 1 1 1 1 1 1 1 1 1 1 1 1 1 1 1 1 1 1 1 1 1 1 1 1 1 1 1 0 
0 1 1 1 1 1 1 1 1 1 1 1 1 1 1 1 1 1 1 1 1 1 1 1 1 1 1 1 1 1 1 1 1 1 1 1 1 1 1 1 1 1 1 1 1 1 1 1 1 1 1 1 1 1 1 1 1 1 1 1 1 1 1 1 1 1 1 1 1 1 1 1 1 1 1 1 1 1 1 0 
0 1 1 1 1 1 1 1 1 1 1 1 1 1 1 1 1 1 1 1 1 1 1 1 1 1 1 1 1 1 1 1 1 1 1 1 1 1 1 1 1 1 1 1 1 1 1 1 1 1 1 1 1 1 1 1 1 1 1 1 1 1 1 1 1 1 1 1 1 1 1 1 1 1 1 1 1 1 1 0 
0 1 1 1 1 2 2 2 2 2 2 2 2 2 1 1 1 1 1 1 1 1 1 1 1 1 1 1 1 1 1 1 1 1 2 2 2 2 2 2 2 2 2 2 1 1 1 1 1 1 1 2 2 2 2 2 2 2 2 2 2 2 2 2 2 2 2 2 2 2 2 2 2 1 1 1 1 1 1 0 
0 1 1 1 1 2 8 4 4 4 4 6 6 2 1 1 1 1 1 2 2 2 2 2 2 2 2 2 2 1 1 1 1 1 2 4 4 4 4 4 7 7 6 2 1 1 1 1 1 1 1 2 4 4 4 4 4 4 4 4 6 6 2 6 4 4 4 4 4 4 4 4 2 1 1 1 1 1 1 0 
0 1 1 1 1 2 4 4 4 4 4 7 7 2 1 1 1 1 1 2 4 4 4 4 4 4 4 6 2 1 1 1 1 1 2 4 4 4 4 4 4 4 4 2 1 1 1 1 1 1 1 2 4 4 4 4 4 4 4 4 7 7 2 7 4 4 4 4 4 4 4 4 2 1 1 1 1 1 1 0 
0 1 1 1 1 2 4 4 4 4 4 7 7 2 1 1 1 1 1 2 4 4 4 4 4 4 4 7 2 1 1 1 1 1 2 4 4 4 4 4 4 4 4 2 1 1 1 1 1 1 1 2 4 4 4 4 4 4 4 4 7 7 2 7 4 4 4 4 4 4 4 4 2 1 3 3 3 3 1 0 
0 1 1 1 1 2 4 4 4 4 4 4 4 1 1 1 1 1 1 2 4 4 4 4 4 4 4 7 2 1 1 1 1 1 2 4 4 4 4 4 4 4 4 1 1 1 1 1 1 1 1 2 4 4 4 4 4 4 4 4 4 4 4 4 4 4 4 4 4 4 4 4 1 1 3 3 3 3 1 0 
0 1 1 1 1 2 4 4 4 4 4 4 4 1 1 1 1 1 1 2 4 4 4 4 4 4 4 4 2 1 1 1 1 1 2 4 4 4 4 4 4 4 4 1 1 1 1 1 1 1 1 2 4 4 4 4 4 4 4 4 4 4 4 4 4 4 4 4 4 4 4 4 1 1 3 3 3 3 1 0 
0 1 1 1 1 2 4 4 4 4 4 7 7 2 1 1 1 1 1 2 4 4 4 4 4 4 4 4 2 1 1 1 1 1 2 4 4 4 4 4 4 4 4 2 1 1 1 1 1 1 1 2 4 4 4 4 4 4 4 4 7 7 2 7 4 4 4 4 4 4 4 4 2 1 3 3 3 3 1 0 
0 1 1 1 1 2 4 4 4 4 4 7 7 2 1 1 1 1 1 2 4 4 4 4 4 7 7 6 2 1 1 1 1 1 2 4 4 4 4 4 4 4 4 2 1 1 1 1 1 1 1 2 4 4 4 4 4 4 4 4 7 7 2 7 4 4 4 4 4 4 4 4 2 1 1 1 1 1 1 0 
0 1 1 1 1 2 8 4 4 4 4 6 6 2 1 1 1 1 1 2 2 2 2 1 1 2 2 2 2 1 1 1 1 1 2 8 4 4 4 4 7 7 6 2 1 1 1 1 1 1 1 2 4 4 4 4 4 4 4 4 6 6 2 6 4 4 4 4 4 4 4 4 2 1 1 1 1 1 1 0 
0 1 1 1 1 2 2 2 2 2 2 2 2 2 1 1 1 1 1 1 1 1 1 1 1 1 1 1 1 1 1 1 1 1 2 2 2 2 2 2 2 2 2 2 1 1 1 1 1 1 1 2 2 2 2 2 2 2 2 2 2 2 2 2 2 2 2 2 2 2 2 2 2 1 1 1 1 1 1 0 
0 1 1 1 1 1 1 1 1 1 1 1 1 1 1 1 1 1 1 1 1 1 1 1 1 1 1 1 1 1 1 1 1 1 1 1 1 1 1 1 1 1 1 1 1 1 1 1 1 1 1 1 1 1 1 1 1 1 1 1 1 1 1 1 1 1 1 1 1 1 1 1 1 1 1 1 1 1 1 0 
0 1 1 1 1 1 1 1 1 1 1 1 1 1 1 1 1 1 1 1 1 1 1 1 1 1 1 1 1 1 1 1 1 1 1 1 1 1 1 1 1 1 1 1 1 1 1 1 1 1 1 1 1 1 1 1 1 1 1 1 1 1 1 1 1 1 1 1 1 1 1 1 1 1 1 1 1 1 1 0 
0 1 1 1 1 1 1 1 1 1 1 1 1 1 1 1 1 1 1 1 1 1 1 1 1 1 1 1 1 1 1 1 1 1 1 1 1 1 1 1 1 1 1 1 1 1 1 1 1 1 1 1 1 1 1 1 1 1 1 1 1 1 1 1 1 1 1 1 1 1 1 1 1 1 1 1 1 1 1 0 
0 1 1 1 1 1 1 1 1 1 1 1 1 1 1 1 1 1 2 2 2 2 2 2 2 2 2 2 2 2 1 1 1 1 1 1 1 1 1 1 1 1 1 1 1 1 1 1 1 1 1 1 1 1 1 1 1 1 1 1 1 1 1 1 1 1 1 1 1 1 1 1 1 1 1 1 1 1 1 0 
0 1 1 1 1 1 2 2 2 2 2 2 2 1 1 1 1 1 2 8 4 4 4 4 4 4 4 6 6 2 1 1 1 1 1 2 2 2 2 2 2 2 2 1 1 1 1 1 1 1 1 2 2 2 2 2 2 2 2 2 2 2 2 2 2 2 2 2 2 2 2 2 2 1 1 1 1 1 1 0 
0 1 1 1 1 1 2 4 4 7 7 6 2 1 1 1 1 1 2 4 4 4 4 4 4 4 4 7 7 2 1 1 1 1 1 2 6 4 4 4 4 8 2 1 1 1 1 1 1 1 1 2 8 4 4 4 4 4 4 4 6 6 2 6 4 4 4 4 4 4 4 8 2 1 1 1 1 1 1 0 
0 1 1 1 1 1 2 4 4 4 4 4 2 1 1 1 1 1 2 4 4 4 4 4 4 4 4 7 7 2 1 1 1 1 1 2 7 4 4 4 4 4 2 1 1 1 1 1 1 1 1 2 8 4 4 4 4 4 4 4 7 7 2 7 4 4 4 4 4 4 4 4 2 1 1 1 1 1 1 0 
0 1 1 1 1 1 1 4 4 4 4 4 2 1 1 1 1 1 1 4 4 4 4 4 4 4 4 4 4 2 1 1 1 1 1 2 7 4 4 4 4 4 2 1 1 1 1 1 1 1 1 2 4 4 4 4 4 4 4 4 7 7 2 7 4 4 4 4 4 4 4 4 2 1 1 1 1 1 1 0 
0 1 1 1 1 1 1 4 4 4 4 4 2 1 1 1 1 1 1 4 4 4 4 4 4 4 4 4 4 2 1 1 1 1 1 2 4 4 4 4 4 4 2 1 1 1 1 1 1 1 1 2 4 4 4 4 4 4 4 4 4 4 4 4 4 4 4 4 4 4 4 4 1 1 1 1 1 1 1 0 
0 1 1 1 1 1 2 4 4 4 4 4 2 1 1 1 1 1 2 4 4 4 4 4 4 4 4 7 7 2 1 1 1 1 1 2 4 4 4 4 4 4 2 1 1 1 1 1 1 1 1 2 4 4 4 4 4 4 4 4 4 4 4 4 4 4 4 4 4 4 4 4 1 1 1 1 1 1 1 0 
0 1 1 1 1 1 2 8 4 4 8 8 2 1 1 1 1 1 2 4 4 4 4 4 4 4 4 7 7 2 1 1 1 1 1 2 4 4 4 4 8 8 2 1 1 1 1 1 1 1 1 2 4 4 4 4 4 4 4 4 7 7 2 7 4 4 4 4 4 4 4 4 2 1 1 1 1 1 1 0 
0 1 1 1 1 1 2 2 2 2 2 2 2 1 1 1 1 1 2 8 4 4 4 4 4 4 4 6 6 2 1 1 1 1 1 2 2 2 1 1 2 2 2 1 1 1 1 1 1 1 1 2 8 4 4 4 4 4 4 4 7 7 2 7 4 4 4 4 4 4 4 4 2 1 1 1 1 1 1 0 
0 1 1 1 1 1 1 1 1 1 1 1 1 1 1 1 1 1 2 2 2 2 2 2 2 2 2 2 2 2 1 1 1 1 1 1 1 1 1 1 1 1 1 1 1 1 1 1 1 1 1 2 8 4 4 4 4 4 4 4 6 6 2 6 4 4 4 4 4 4 4 8 2 1 1 1 1 1 1 0 
0 1 1 1 1 1 1 1 1 1 1 1 1 1 1 1 1 1 1 1 1 1 1 1 1 1 1 1 1 1 1 1 1 1 1 1 1 1 1 1 1 1 1 1 1 1 1 1 1 1 1 2 2 2 2 2 2 2 2 2 2 2 2 2 2 2 2 2 2 2 2 2 2 1 1 1 1 1 1 0 
0 1 1 1 1 1 1 1 1 1 1 1 1 1 1 1 1 1 1 1 1 1 1 1 1 1 1 1 1 1 1 1 1 1 1 1 1 1 1 1 1 1 1 1 1 1 1 1 1 1 1 1 1 1 1 1 1 1 1 1 1 1 1 1 1 1 1 1 1 1 1 1 1 1 1 1 1 1 1 0 
0 1 1 1 1 1 1 1 1 1 1 1 1 1 1 1 1 1 1 1 1 1 1 1 1 1 1 1 1 1 1 1 1 1 1 1 1 1 1 1 1 1 1 1 1 1 1 1 1 1 1 1 1 1 1 1 1 1 1 1 1 1 1 1 1 1 1 1 1 1 1 1 1 1 1 1 1 1 1 0 
0 1 1 1 1 2 2 2 2 2 2 2 2 2 2 2 2 2 2 2 2 2 2 2 2 2 2 2 2 2 1 1 1 1 1 1 1 1 1 1 1 1 1 1 1 1 1 1 1 1 1 1 1 1 1 1 1 1 1 1 1 1 1 1 1 1 1 1 1 1 1 1 1 1 1 1 1 1 1 0 
0 1 1 1 1 2 8 4 4 4 4 4 4 4 4 6 2 6 7 7 4 4 4 4 4 4 4 4 8 2 1 1 1 1 1 1 1 1 1 1 1 1 1 1 1 1 1 1 1 1 1 1 1 1 1 1 1 1 1 1 1 1 1 1 1 1 1 1 1 1 1 1 1 1 1 1 1 1 1 0 
0 1 1 1 1 2 4 4 4 4 4 4 4 4 4 7 2 6 7 7 4 4 4 4 4 4 4 4 8 2 1 1 1 1 1 1 1 1 1 1 1 1 1 1 1 1 1 1 1 1 1 2 2 2 2 2 2 2 2 2 1 1 1 1 2 2 2 2 2 2 2 2 2 1 1 1 1 1 1 0 
0 1 1 1 1 2 4 4 4 4 4 4 4 4 4 7 2 4 4 4 4 4 4 4 4 4 4 4 4 2 1 1 1 1 1 1 1 1 1 1 1 1 1 1 1 1 1 1 1 1 1 2 4 4 4 4 4 4 6 2 1 1 1 1 2 6 4 4 4 4 4 4 2 1 1 1 1 1 1 0 
0 1 1 1 1 2 4 4 4 4 4 4 4 4 4 4 4 4 4 4 4 4 4 4 4 4 4 4 4 1 1 1 1 1 1 1 1 1 1 1 1 1 1 1 1 1 1 1 1 1 1 2 4 4 4 4 4 4 7 2 1 1 1 1 2 7 4 4 4 4 4 4 2 1 3 3 3 3 1 0 
0 1 1 1 1 2 4 4 4 4 4 4 4 4 4 4 4 4 4 4 4 4 4 4 4 4 4 4 4 1 1 1 1 1 1 1 3 3 3 3 3 3 3 3 3 1 1 1 1 1 1 4 4 4 4 4 4 4 7 2 1 1 1 1 2 7 4 4 4 4 4 4 4 1 3 3 3 3 1 0 
0 1 1 1 1 2 4 4 4 4 4 4 4 4 4 7 2 4 4 4 4 4 4 4 4 4 4 4 4 2 1 1 1 1 1 1 3 3 3 3 3 3 3 3 3 1 1 1 1 1 1 4 4 4 4 4 4 4 4 2 1 1 1 1 2 4 4 4 4 4 4 4 4 1 3 3 3 3 1 0 
0 1 1 1 1 2 4 4 4 4 4 4 4 4 4 7 2 6 7 7 4 4 4 4 4 4 4 4 8 2 1 1 1 1 1 1 3 3 3 3 3 3 3 3 3 1 1 1 1 1 1 2 4 4 4 4 4 4 4 2 1 1 1 1 2 4 4 4 4 4 4 4 2 1 3 3 3 3 1 0 
0 1 1 1 1 2 8 4 4 4 4 4 4 4 4 6 2 6 7 7 4 4 4 4 4 4 4 4 8 2 1 1 1 1 1 1 3 3 3 3 3 3 3 3 3 1 1 1 1 1 1 2 4 4 4 4 4 4 4 2 1 1 1 1 2 4 4 4 4 4 4 4 2 1 1 1 1 1 1 0 
0 0 0 0 0 0 0 0 0 0 0 0 0 0 0 0 0 0 0 0 0 0 0 0 0 0 0 0 0 0 0 0 0 0 0 0 0 0 0 0 0 0 0 0 0 0 0 0 0 0 0 0 0 0 0 0 0 0 0 0 0 0 0 0 0 0 0 0 0 0 0 0 0 0 0 0 0 0 0 0 
