0 0 0 0 0 0 0 0 0 0 0 0 0 0 0 0 0 0 0 0 0 0 0 0 0 0 0 0 0 0 0 0 0 0 0 0 0 0 0 0 0 0 0 0 0 0 0 0 0 0 0 0 0 0 0 0 0 0 0 0 0 0 0 0 0 0 0 0 0 0 0 0 0 0 0 0 0 0 0 0 
0 4 4 4 4 4 4 4 4 4 4 4 4 4 4 4 4 4 4 4 4 4 4 4 4 4 4 4 4 4 4 4 4 4 2 1 1 3 3 3 3 1 1 1 1 1 1 1 1 1 1 1 1 1 1 1 1 1 1 1 1 1 1 1 1 1 1 1 1 1 1 1 1 1 1 1 1 1 1 0 
0 4 4 4 4 4 4 4 4 4 4 4 4 4 4 4 4 4 4 4 4 4 4 4 4 4 4 4 4 4 4 4 4 4 2 1 1 3 3 3 3 1 1 1 1 1 1 1 1 1 1 1 1 1 1 1 1 1 1 1 1 1 1 1 1 1 1 1 1 1 1 1 1 1 1 1 3 3 3 0 
0 4 4 4 4 4 2 2 2 2 2 2 2 2 2 4 4 4 4 4 2 2 2 2 2 2 2 2 2 4 4 4 4 4 2 1 1 1 1 1 1 1 1 1 1 1 1 1 1 1 1 1 1 1 1 1 1 1 1 1 1 1 1 1 1 1 1 1 1 1 1 1 1 1 1 1 3 3 3 0 
0 4 4 4 4 4 2 6 6 8 9 9 8 13 2 14 4 4 4 14 2 11 8 9 9 8 6 6 2 4 4 4 4 4 2 1 1 1 1 1 1 1 1 1 1 1 1 1 1 1 1 1 1 1 1 1 1 1 1 1 1 1 1 1 1 1 1 1 1 1 1 1 1 1 1 1 3 3 3 0 
0 4 4 4 4 4 2 7 7 13 13 13 13 13 13 4 4 4 4 4 11 11 11 11 11 11 7 7 2 4 4 4 4 4 2 1 1 1 1 1 1 1 1 1 1 1 1 1 1 1 1 1 1 1 1 1 1 1 1 1 1 1 1 1 1 1 1 1 1 1 1 1 1 1 1 1 1 1 1 0 
0 4 4 4 4 4 2 7 7 13 13 13 13 13 13 4 4 4 4 4 11 11 11 11 11 11 7 7 2 4 4 4 4 4 2 1 1 1 1 1 1 1 1 1 1 1 1 1 1 1 1 1 1 1 1 1 1 1 1 1 1 1 1 1 1 1 1 1 1 2 2 2 2 2 2 2 2 2 2 0 
0 4 4 4 4 4 2 13 13 13 13 13 13 13 13 4 4 4 4 4 11 11 11 11 11 11 11 11 2 4 4 4 4 4 2 1 1 1 1 1 1 1 1 1 1 1 1 1 1 1 1 1 1 1 1 1 1 1 1 1 1 1 1 1 1 1 1 1 14 2 1 1 1 1 1 1 1 1 1 0 
0 4 4 4 4 4 2 13 13 13 13 13 13 13 2 14 4 4 4 14 2 11 11 11 11 11 11 11 2 4 4 4 4 4 2 1 1 1 1 1 1 1 1 1 1 1 1 1 1 1 1 1 1 1 1 1 1 1 1 1 1 1 1 1 1 1 1 1 1 1 1 1 1 1 1 1 1 1 1 0 
0 4 4 4 4 4 2 2 2 2 2 2 2 2 2 4 4 4 4 4 2 2 2 2 2 2 2 2 2 4 4 4 4 4 2 1 1 1 1 1 1 1 1 1 1 1 1 1 1 1 1 1 1 1 1 1 1 1 1 1 1 1 1 1 1 1 1 1 1 1 1 1 1 1 1 1 1 1 1 0 
0 4 4 4 4 4 4 4 4 4 4 4 4 4 4 4 4 4 4 4 4 4 4 4 4 4 4 4 4 4 4 4 4 4 2 1 1 1 1 1 1 1 1 1 1 1 1 1 1 1 1 1 1 1 1 1 1 1 1 1 1 1 1 1 1 1 1 1 1 2 1 1 1 1 1 1 1 1 1 0 
0 4 4 4 4 4 4 4 4 4 4 4 4 4 4 4 4 4 4 4 4 4 4 4 4 4 4 4 4 4 4 4 4 4 2 1 1 1 1 1 1 1 1 1 1 1 1 1 1 1 1 1 1 1 1 1 1 1 1 1 1 1 1 1 1 1 1 1 1 2 1 1 1 2 2 2 1 1 1 0 
0 2 1 1 1 2 2 2 2 2 2 2 2 2 2 2 2 2 2 2 2 2 2 2 2 2 2 2 2 2 2 2 2 2 2 1 1 1 1 1 1 1 1 1 1 1 1 1 1 1 1 1 1 1 1 1 1 1 1 1 1 1 1 1 1 1 1 1 1 2 1 1 1 2 2 2 1 1 1 0 
0 1 1 1 1 1 1 1 1 1 1 1 1 1 1 1 1 1 1 1 1 1 1 1 2 2 1 1 1 1 1 1 1 1 1 1 1 1 1 1 1 1 1 1 1 1 1 1 1 1 1 1 1 1 1 1 1 1 1 1 1 1 1 1 1 1 1 1 1 2 1 1 1 2 2 2 1 1 1 0 
0 1 1 1 1 1 1 1 1 1 1 1 1 1 1 1 1 1 1 1 1 1 1 1 2 2 1 1 1 1 1 1 1 1 1 1 1 1 1 1 1 1 1 1 1 1 1 1 1 1 1 1 1 1 1 1 1 1 1 1 1 1 1 1 1 1 1 1 1 2 1 1 1 2 2 2 1 1 1 0 
0 1 1 1 1 1 1 1 1 1 1 1 1 1 1 1 1 1 1 1 1 1 1 1 2 2 1 1 1 1 1 1 1 1 1 1 1 1 1 1 1 1 1 1 1 1 1 1 1 1 1 1 2 2 2 2 2 2 2 2 2 2 2 2 1 1 1 1 1 2 1 1 1 2 2 2 1 1 1 0 
0 1 1 1 1 1 1 1 1 1 1 1 1 1 1 1 1 1 1 1 1 1 1 1 2 2 1 1 1 1 1 1 1 1 1 1 1 1 1 1 1 1 1 1 1 1 1 1 1 1 1 1 2 13 10 10 10 13 13 13 13 6 6 2 1 1 1 1 1 2 1 1 1 2 2 2 1 1 1 0 
0 1 1 1 1 1 1 1 1 1 1 1 1 1 1 1 1 1 1 1 1 1 1 1 2 2 1 1 1 1 1 1 1 1 1 1 1 1 1 1 1 1 1 1 1 1 1 1 1 1 1 1 2 13 13 13 13 13 13 13 13 7 7 2 1 1 1 1 1 2 1 1 1 2 2 2 1 1 1 0 
0 1 1 1 1 1 1 1 1 1 1 1 1 1 1 1 1 1 1 1 1 1 1 1 1 1 1 1 1 1 1 1 1 1 1 1 1 1 1 1 1 1 1 1 1 1 1 1 1 1 1 1 2 13 13 13 13 13 13 13 13 7 7 2 1 1 1 1 1 2 1 1 1 2 2 2 1 1 1 0 
0 1 1 1 1 1 1 2 2 1 1 2 2 2 2 2 2 2 2 2 2 1 1 1 1 1 1 1 1 2 2 2 2 2 2 2 2 2 1 1 2 2 2 1 1 1 1 1 1 1 1 14 2 13 13 13 13 13 13 13 13 13 13 2 1 1 1 1 1 2 1 1 1 2 2 2 1 1 1 0 
0 1 1 1 1 1 1 2 14 4 4 14 4 4 2 15 16 19 17 18 2 1 1 1 1 1 1 1 1 2 19 19 19 17 18 2 4 14 4 4 14 4 2 1 1 1 1 1 1 1 1 1 1 13 13 13 13 13 13 13 13 13 13 2 1 1 1 1 1 2 1 1 1 2 2 2 1 1 1 0 
0 1 1 1 1 1 1 2 4 4 4 4 4 4 2 19 19 19 19 19 2 1 1 1 1 1 1 1 1 2 19 19 19 19 19 2 4 4 4 4 4 4 2 1 1 1 1 1 1 1 1 1 1 13 13 13 13 8 13 13 13 13 13 2 1 1 1 1 1 2 1 1 1 1 1 1 1 1 1 0 
0 1 1 1 1 1 1 2 4 4 4 4 4 4 2 19 19 19 19 19 2 1 1 1 1 1 1 1 1 2 19 19 19 19 19 2 4 4 4 4 4 4 2 1 1 1 1 1 1 1 1 14 2 13 13 13 9 9 9 13 13 13 13 2 1 1 1 1 1 1 1 1 1 1 1 1 1 1 1 0 
0 1 1 1 1 1 1 2 4 4 4 4 4 4 2 19 19 19 19 19 2 1 1 1 1 1 1 1 1 2 19 19 19 19 19 2 4 4 4 4 4 4 2 1 1 1 1 1 1 1 1 1 2 13 13 8 9 9 9 8 13 13 13 2 1 1 1 1 1 1 1 1 1 1 1 1 1 1 1 0 
0 1 1 1 1 1 1 2 4 4 4 4 4 4 2 19 19 19 19 19 2 1 1 1 1 1 1 1 1 2 19 19 19 15 16 2 4 4 4 4 4 4 2 1 1 1 1 1 1 1 1 1 2 13 13 13 9 9 9 13 13 13 13 2 1 1 1 1 14 2 1 1 1 1 1 1 1 1 1 0 
0 1 1 1 1 1 1 2 4 4 4 4 4 4 2 2 2 2 11 11 2 1 1 1 1 1 1 1 1 2 13 13 2 2 2 2 4 4 4 4 4 4 2 1 1 1 1 1 1 1 1 1 2 13 13 13 13 8 13 13 12 12 12 2 1 1 1 1 1 2 2 2 2 2 2 2 2 2 2 0 
0 1 1 1 1 1 1 2 4 4 4 4 4 4 2 6 6 11 11 11 2 1 1 1 1 1 1 1 1 2 13 13 13 6 6 2 4 4 4 4 4 4 2 1 1 1 1 1 1 1 1 1 2 2 2 2 2 2 2 2 2 2 2 2 1 1 1 1 1 1 1 1 1 1 1 1 1 1 1 0 
0 1 1 1 1 1 1 2 4 8 4 4 4 4 2 7 7 11 11 11 2 1 1 1 1 1 1 1 1 2 13 13 13 7 7 2 4 4 4 4 4 4 2 1 1 1 1 1 1 1 1 1 1 1 1 1 1 1 1 1 1 1 1 1 1 1 1 1 1 1 1 1 1 1 1 1 1 1 1 0 
0 1 1 1 1 1 1 2 9 9 9 4 4 4 2 7 7 11 11 11 2 1 1 1 1 1 1 1 1 2 13 13 13 7 7 2 4 4 4 4 8 4 2 1 1 1 1 1 1 1 1 1 1 1 1 1 1 1 1 1 1 1 1 1 1 1 1 1 1 1 1 1 1 1 1 1 1 1 1 0 
0 1 1 1 1 1 1 2 9 9 9 8 4 4 4 11 11 11 11 11 2 1 1 1 1 1 1 1 1 2 13 13 13 13 13 13 4 4 4 9 9 9 2 1 1 1 1 1 1 1 1 1 1 1 1 1 1 1 1 1 1 1 1 1 1 1 1 1 1 1 1 1 1 1 1 1 1 1 1 0 
0 1 1 1 1 1 1 2 9 9 9 4 4 4 4 11 11 11 11 11 2 1 1 1 1 1 1 1 1 2 13 13 13 13 13 13 4 4 8 9 9 9 2 1 1 1 1 1 1 1 1 1 1 1 1 1 1 1 1 2 2 2 2 2 2 2 2 2 2 2 1 1 1 1 1 1 1 1 1 0 
0 1 1 1 1 1 1 2 2 2 2 2 2 2 2 2 2 2 2 2 2 1 1 1 1 1 1 1 1 2 2 2 2 2 2 2 2 2 2 2 2 2 2 1 1 1 1 1 1 1 1 1 1 1 1 1 1 1 1 2 6 6 4 4 4 8 4 4 4 2 1 1 1 1 1 1 1 1 1 0 
0 1 1 1 1 1 1 1 1 1 1 1 1 1 1 1 1 1 1 1 1 1 1 1 1 1 1 1 1 1 1 1 1 1 1 1 1 1 1 1 1 1 1 1 1 1 1 1 1 1 1 1 1 1 1 1 1 1 1 2 7 7 4 4 9 9 9 4 4 2 1 1 1 1 1 1 1 1 1 0 
0 1 1 1 1 1 1 1 1 1 1 1 1 1 1 1 1 1 1 1 1 1 1 1 1 1 1 1 1 1 1 1 1 1 1 1 1 1 1 1 1 1 1 1 1 1 1 2 2 1 1 1 1 1 1 1 1 1 1 2 7 7 4 4 9 9 9 4 4 2 14 1 1 1 1 1 1 1 1 0 
0 1 1 1 1 1 1 1 1 1 1 1 1 1 1 1 1 1 1 1 1 1 1 1 2 2 1 1 1 1 1 1 1 1 1 1 1 1 1 1 1 1 1 1 1 1 1 2 2 1 1 1 1 1 1 1 1 1 1 2 4 4 4 4 4 8 4 4 4 1 1 1 1 1 1 1 1 1 1 0 
0 1 3 3 3 3 1 1 1 1 1 1 1 1 1 1 1 1 1 1 1 1 1 1 2 2 1 1 1 1 1 1 1 1 1 1 1 1 1 1 1 1 1 1 1 1 1 2 2 1 1 1 1 1 1 1 1 1 1 2 4 4 4 4 4 4 4 4 4 1 1 1 1 1 1 1 1 1 1 0 
0 1 3 3 3 3 1 1 1 1 1 1 1 1 1 1 1 1 1 1 1 1 1 1 2 2 1 1 1 1 1 1 1 1 1 1 1 1 1 1 1 1 1 1 1 1 1 2 2 1 1 1 1 1 1 1 1 1 1 2 4 4 4 4 4 4 4 4 4 2 14 1 1 3 3 3 3 1 1 0 
0 1 3 3 3 3 1 1 1 1 1 1 1 1 1 1 1 1 1 1 1 1 1 1 2 2 1 1 1 1 1 1 1 1 1 1 1 1 1 1 1 1 1 1 1 1 1 2 2 1 1 1 1 1 1 1 1 1 1 2 4 4 4 4 4 4 4 4 4 2 1 1 1 3 3 3 3 1 1 0 
0 1 3 3 3 3 1 1 1 1 1 1 1 1 1 1 1 1 1 1 1 1 1 1 2 2 1 1 1 1 1 1 1 1 1 1 1 1 1 1 1 1 1 1 1 1 1 2 2 1 1 1 1 1 1 1 1 1 1 2 4 12 12 12 4 4 4 4 4 2 1 1 1 3 3 3 3 1 1 0 
0 0 0 0 0 0 0 0 0 0 0 0 0 0 0 0 0 0 0 0 0 0 0 0 0 0 0 0 0 0 0 0 0 0 0 0 0 0 0 0 0 0 0 0 0 0 0 0 0 0 0 0 0 0 0 0 0 0 0 0 0 0 0 0 0 0 0 0 0 0 0 0 0 0 0 0 0 0 0 0 
