0 0 0 0 0 0 0 0 0 0 0 0 0 0 0 0 0 0 0 0 0 0 0 0 0 0 0 0 0 0 0 0 0 0 0 0 0 0 0 0 0 0 0 0 0 0 0 0 0 0 0 0 0 0 0 0 0 0 0 0 0 0 0 0 0 0 0 0 0 0 0 0 0 0 0 0 0 0 0 0 
0 15 16 19 17 19 18 2 5 5 5 5 5 5 5 5 5 5 5 13 13 13 10 10 10 13 13 13 13 6 6 2 1 1 1 1 1 1 1 1 1 1 1 1 1 1 1 1 1 1 1 1 1 1 1 1 1 1 1 1 1 1 1 1 1 1 1 1 1 1 1 1 2 15 16 19 17 19 18 0 
0 19 19 19 19 19 19 2 5 5 5 5 5 8 5 5 5 5 5 13 13 13 13 13 13 13 13 13 13 7 7 2 1 1 1 1 1 1 1 1 1 1 1 1 1 1 1 1 1 1 1 1 1 1 1 1 1 1 1 1 1 1 1 1 1 1 1 1 1 1 1 1 2 19 19 19 19 19 19 0 
0 19 19 19 19 19 19 2 5 5 5 5 9 9 9 5 5 5 5 13 13 13 13 13 13 13 13 13 13 7 7 2 1 1 1 1 1 1 1 1 1 1 1 1 1 1 1 1 1 1 1 1 1 1 1 1 1 1 1 1 1 1 1 1 1 1 1 1 1 1 1 1 2 19 19 19 19 19 19 0 
0 19 19 19 19 19 19 5 5 5 5 5 9 9 9 5 5 5 5 13 13 13 13 13 13 13 13 13 13 13 13 2 1 1 1 1 1 1 1 1 1 1 1 1 1 1 1 1 1 1 1 1 1 1 1 1 1 1 1 1 1 1 1 1 1 1 1 1 1 1 1 1 2 19 19 19 19 19 19 0 
0 19 19 19 19 19 19 5 5 5 5 5 9 9 9 5 5 5 5 13 13 13 13 13 13 13 13 13 13 13 13 2 1 1 1 1 1 1 1 1 1 1 1 1 1 1 1 1 1 1 1 1 1 1 1 1 1 1 1 1 1 1 1 1 1 1 1 1 1 1 1 1 2 19 19 19 19 19 19 0 
0 19 19 19 19 19 19 2 5 5 5 5 5 8 5 5 5 5 5 13 13 13 13 13 13 13 13 13 13 7 7 2 1 1 1 1 1 1 1 1 1 1 1 1 1 1 1 1 1 1 1 1 1 1 1 1 1 1 1 1 1 1 1 1 1 1 1 1 1 1 1 1 2 19 19 19 19 19 19 0 
0 19 19 19 19 19 19 2 5 5 5 5 5 5 5 5 5 5 5 13 13 13 13 13 13 13 13 13 13 7 7 2 1 1 1 1 1 1 1 1 1 1 1 1 1 1 1 1 1 1 1 1 1 1 1 1 1 1 1 1 1 1 1 1 1 1 1 1 1 1 1 1 2 19 19 19 19 19 19 0 
0 2 2 2 2 2 2 2 5 5 5 5 5 5 5 5 5 5 5 13 13 13 13 13 13 13 13 13 13 6 6 2 1 1 1 1 1 1 1 1 1 1 1 1 1 1 1 1 1 1 1 1 1 1 1 1 1 1 1 1 1 1 1 1 1 1 1 1 1 1 1 1 2 2 2 2 13 13 13 0 
0 6 6 4 4 4 4 2 2 2 2 2 2 2 2 2 2 2 2 1 1 2 2 2 2 2 2 2 2 2 2 2 1 1 1 1 1 1 1 1 1 1 1 1 1 1 1 1 1 1 1 1 1 1 1 1 1 1 1 1 1 1 1 1 1 1 1 1 2 2 2 2 2 13 13 13 13 13 13 0 
0 7 7 4 4 4 4 4 4 4 4 2 1 1 1 1 1 1 1 1 1 1 1 1 1 1 1 1 1 1 1 1 1 1 1 1 1 1 1 1 1 1 1 1 1 1 1 1 1 1 1 1 1 1 1 1 1 1 1 1 1 1 1 1 1 1 1 1 2 13 13 13 13 13 13 13 13 13 8 0 
0 7 7 4 4 4 4 4 4 4 4 2 1 1 1 1 1 1 1 1 1 1 1 1 1 1 1 1 1 1 1 1 1 1 1 1 1 1 1 1 1 2 2 2 2 2 2 2 2 2 2 2 2 2 2 2 2 2 2 1 1 1 1 1 1 1 1 1 2 13 13 13 13 13 13 13 13 9 9 0 
0 4 4 4 4 4 4 4 4 4 4 2 14 1 1 1 1 1 1 1 1 1 1 1 1 1 1 1 1 1 1 1 1 1 1 1 1 1 1 1 1 2 13 13 8 8 13 13 13 13 13 13 13 13 13 13 13 13 2 1 1 1 1 1 1 1 1 1 1 13 13 13 13 13 13 13 13 9 9 0 
0 4 4 4 4 4 4 4 4 4 4 1 1 1 1 1 1 1 1 1 1 1 1 1 1 1 1 1 1 1 1 1 1 1 1 1 1 1 1 1 1 2 13 9 9 9 9 13 13 13 13 13 13 13 13 13 13 13 2 1 1 1 1 1 1 1 1 1 1 13 13 13 13 13 13 13 13 9 9 0 
0 4 4 4 4 4 4 4 4 4 4 1 1 1 1 1 1 1 1 1 1 1 1 1 1 1 1 1 1 1 1 1 1 1 1 1 1 1 1 1 1 2 13 9 9 9 9 13 13 13 13 13 13 13 13 13 13 13 2 1 1 1 1 1 1 1 1 1 2 13 13 13 13 13 13 13 13 9 9 0 
0 4 4 4 4 4 4 4 4 4 4 2 14 1 1 1 1 1 1 1 1 1 1 1 1 1 1 1 1 1 1 1 1 1 1 1 1 1 1 1 1 2 13 9 9 9 9 13 13 13 13 13 13 13 13 13 13 13 2 1 1 1 1 1 1 1 1 1 2 13 13 13 13 13 13 13 13 13 8 0 
0 4 4 4 4 4 4 4 4 4 8 2 1 1 1 1 1 1 1 1 1 1 1 1 1 1 1 1 1 1 1 1 1 1 1 1 1 1 1 1 1 2 13 13 8 8 13 13 13 13 13 13 13 13 13 13 13 13 2 1 1 1 1 1 1 1 1 1 2 7 7 13 13 13 13 13 13 13 13 0 
0 4 4 4 4 4 4 4 4 9 9 2 1 1 1 1 1 1 1 1 1 1 1 1 1 1 1 1 1 1 1 1 1 1 1 1 1 1 1 1 1 2 13 13 13 13 13 13 13 13 14 14 13 13 13 13 14 13 2 1 1 1 1 1 1 1 1 1 2 7 7 13 13 13 13 13 13 13 13 0 
0 4 4 4 4 4 4 4 8 9 9 2 1 1 1 1 1 1 1 1 1 1 1 1 1 1 1 1 1 1 1 1 1 1 1 1 1 1 1 1 1 2 13 13 13 13 13 13 13 2 2 2 2 13 13 2 2 2 2 1 1 1 1 1 1 1 1 1 2 6 6 13 13 13 13 13 12 12 12 0 
0 2 2 2 4 4 4 4 2 2 2 2 1 1 1 1 1 1 1 1 1 1 1 1 1 1 1 1 1 1 1 1 1 1 1 1 1 1 1 1 1 2 13 13 13 13 13 13 13 2 10 10 10 4 4 10 10 10 2 1 1 1 1 1 1 1 1 1 2 2 2 2 13 13 13 13 2 2 2 0 
0 2 2 2 4 4 4 4 2 2 2 2 1 1 1 1 1 1 1 1 1 1 1 1 1 1 1 1 1 1 1 1 1 1 1 1 1 1 1 1 1 2 13 13 13 13 13 13 13 2 4 4 4 4 4 4 4 4 2 1 1 1 1 1 1 1 1 1 2 2 2 2 5 5 5 5 2 2 2 0 
0 10 10 10 11 11 11 11 8 9 9 2 1 1 1 1 1 1 1 1 1 1 1 1 1 1 1 1 1 1 1 1 1 1 1 1 1 1 1 1 1 2 13 13 13 13 13 13 14 2 4 4 4 4 4 4 4 4 2 1 1 1 1 1 1 1 1 1 2 6 6 11 11 11 11 11 10 10 10 0 
0 11 11 11 11 11 11 11 11 9 9 2 1 1 1 1 1 1 1 1 1 1 1 1 1 1 1 1 1 1 1 1 1 1 1 1 1 1 1 1 1 2 13 13 13 13 13 13 14 2 4 4 4 4 4 4 4 4 2 1 1 1 1 1 1 1 1 1 2 7 7 11 11 11 11 11 11 11 11 0 
0 11 11 11 11 11 11 11 11 11 8 2 1 1 1 1 1 1 1 1 1 1 1 1 1 1 1 1 1 1 1 1 1 1 1 1 1 1 1 1 1 2 13 13 13 13 13 13 13 2 6 7 7 4 4 7 7 6 2 1 1 1 1 1 1 1 1 1 2 7 7 11 11 11 11 11 11 11 11 0 
0 11 11 11 11 11 11 11 11 11 11 2 14 1 1 1 1 1 1 1 1 1 1 1 1 1 1 1 1 1 1 1 1 1 1 1 1 1 1 1 1 2 13 13 13 13 13 13 13 2 6 7 7 4 4 7 7 6 2 1 1 1 1 1 1 1 1 1 2 11 11 11 11 11 11 11 11 11 11 0 
0 11 11 11 11 11 11 11 11 11 11 1 1 1 1 1 1 1 1 1 1 1 1 1 1 1 1 1 1 1 1 1 1 1 1 1 1 1 1 1 1 2 1 1 2 2 2 2 2 2 2 2 2 2 2 2 2 2 2 1 1 1 1 1 1 1 1 1 2 11 11 11 11 11 11 8 8 11 11 0 
0 11 11 11 11 11 11 11 11 11 11 1 1 1 1 1 1 1 1 1 1 1 1 1 1 1 1 1 1 1 1 1 1 1 1 1 1 1 1 1 1 1 1 1 1 1 1 1 1 1 1 1 1 1 1 1 1 1 1 1 1 1 1 1 1 1 1 1 1 11 11 11 11 11 9 9 9 9 11 0 
0 11 11 11 11 11 11 11 11 11 11 2 14 1 1 1 1 1 1 1 1 1 1 1 1 1 1 1 1 1 1 1 1 1 1 1 1 1 1 1 1 1 1 1 1 1 1 1 1 1 1 1 1 1 1 1 1 1 1 1 1 1 1 1 1 1 1 1 1 11 11 11 11 11 9 9 9 9 11 0 
0 7 7 11 11 11 11 11 11 11 11 2 1 1 1 1 1 1 1 1 1 1 1 1 1 1 1 1 1 1 1 1 1 1 1 1 1 1 1 1 1 1 1 1 1 1 1 1 1 1 1 1 1 1 1 1 1 1 1 1 1 1 1 1 1 1 1 1 2 11 11 11 11 11 9 9 9 9 11 0 
0 7 7 11 11 11 11 11 11 11 11 2 1 1 1 1 1 1 1 1 1 1 1 1 1 1 1 1 1 1 1 1 1 1 1 1 1 1 1 1 1 1 1 1 1 1 1 1 1 1 1 1 1 1 1 1 1 1 1 1 1 1 1 1 1 1 1 1 2 11 11 11 11 11 11 8 8 11 11 0 
0 6 6 11 11 11 11 2 2 2 2 2 1 1 1 1 1 1 1 1 1 1 1 1 1 1 1 1 1 1 1 1 1 1 1 1 1 1 1 1 1 1 1 1 1 1 1 1 2 2 2 2 2 2 2 2 2 2 2 1 1 2 2 2 2 2 2 2 2 2 2 2 2 11 11 11 11 11 11 0 
0 2 2 2 2 2 2 2 1 1 1 1 1 1 1 1 1 1 1 1 1 1 1 1 1 1 1 1 1 1 1 1 1 1 1 1 1 1 1 1 1 1 1 1 1 1 1 1 2 5 5 5 5 5 5 5 5 5 5 5 5 5 5 5 5 5 5 5 5 5 5 5 2 2 2 2 2 2 2 0 
0 18 13 13 7 7 6 2 1 1 1 1 1 1 1 1 1 1 1 1 1 1 1 1 1 1 1 1 1 1 1 1 1 1 1 1 1 1 1 1 1 1 1 1 1 1 1 1 2 5 5 5 5 5 5 5 5 5 5 5 5 5 5 5 5 5 5 5 5 5 5 5 2 15 16 19 17 19 18 0 
0 13 13 13 13 13 13 2 1 1 1 1 1 1 1 1 1 1 1 1 1 1 1 1 1 1 1 1 1 1 1 1 1 1 1 1 1 1 1 1 1 1 1 1 1 1 1 1 2 5 5 5 8 8 5 5 5 5 5 5 5 5 5 5 5 5 5 8 8 5 5 5 2 19 19 19 19 19 19 0 
0 13 13 8 13 13 13 1 1 1 1 1 1 1 1 1 1 1 1 1 1 1 1 1 1 1 1 1 1 1 1 1 1 1 1 1 1 1 1 1 1 1 1 1 1 1 1 1 2 5 5 9 9 9 9 5 5 5 5 5 5 5 5 5 5 5 9 9 9 9 5 5 5 19 19 19 19 19 19 0 
0 13 9 9 9 13 13 1 1 1 1 1 1 1 1 1 1 1 1 1 1 1 1 1 1 1 1 1 1 1 1 1 1 1 1 1 1 1 1 1 1 1 1 1 1 1 1 1 2 5 5 9 9 9 9 5 5 5 5 5 5 5 5 5 5 5 9 9 9 9 5 5 5 19 19 19 19 19 19 0 
0 13 9 9 9 13 13 2 1 1 1 1 1 1 1 1 1 1 1 1 1 1 1 1 1 1 1 1 1 1 1 1 1 1 1 1 1 3 3 3 3 3 1 1 1 1 1 1 2 5 5 9 9 9 9 5 5 5 5 5 5 5 5 5 5 5 9 9 9 9 5 5 2 19 19 19 19 19 19 0 
0 13 13 8 13 13 13 2 1 1 1 1 1 1 1 1 1 1 1 1 1 1 1 1 1 1 1 1 1 1 1 1 1 1 1 1 1 3 3 3 3 3 1 1 1 1 1 1 2 5 5 5 8 8 5 5 5 5 5 5 5 5 5 5 5 5 5 8 8 5 5 5 2 19 19 19 19 19 19 0 
0 13 13 13 13 13 13 2 1 1 1 1 1 1 1 1 1 1 1 1 1 1 1 1 1 1 1 1 1 1 1 1 1 1 1 1 1 3 3 3 3 3 1 1 1 1 1 1 2 5 5 5 5 5 5 5 5 5 5 5 5 5 5 5 5 5 5 5 5 5 5 5 2 19 19 19 19 19 19 0 
0 0 0 0 0 0 0 0 0 0 0 0 0 0 0 0 0 0 0 0 0 0 0 0 0 0 0 0 0 0 0 0 0 0 0 0 0 0 0 0 0 0 0 0 0 0 0 0 0 0 0 0 0 0 0 0 0 0 0 0 2 2 2 2 2 2 2 0 0 0 0 0 0 0 0 0 0 0 0 0 
