0 0 0 0 0 0 0 0 0 0 0 0 0 0 0 0 0 0 0 0 0 0 2 2 2 2 2 2 2 2 2 2 2 2 2 2 2 2 2 2 2 2 2 2 2 2 2 2 2 2 2 2 2 2 2 2 2 2 2 2 2 2 2 2 2 2 2 2 2 2 2 2 2 2 2 2 2 2 2 2 
0 3 3 4 4 4 4 4 2 1 1 1 1 1 1 1 1 1 1 1 1 2 1 1 1 2 4 4 4 4 4 2 1 1 2 4 4 4 4 3 3 4 4 4 4 2 1 1 1 1 1 1 2 1 1 1 1 1 2 1 1 1 2 1 1 1 2 1 1 1 2 1 1 2 4 4 3 3 3 2 
0 3 3 4 4 4 4 4 2 1 1 1 1 1 1 1 1 1 1 1 1 2 1 1 1 2 4 4 4 4 4 2 1 1 2 4 4 4 4 3 3 4 4 4 4 2 1 1 1 1 1 1 1 1 1 1 1 1 2 1 1 1 2 1 1 1 1 1 1 1 2 1 1 2 4 4 3 3 3 2 
0 3 3 4 4 4 4 4 2 1 1 1 1 1 2 1 1 1 1 1 1 2 1 1 1 2 4 4 4 4 4 1 1 1 2 4 4 4 4 4 4 4 4 4 4 2 1 1 1 1 1 1 1 1 1 1 1 1 2 1 1 1 2 1 1 1 1 1 1 1 1 1 1 2 4 4 4 4 4 2 
0 4 4 4 4 4 4 4 2 1 1 1 1 1 2 1 1 1 1 1 1 2 1 1 1 2 4 4 4 4 4 1 1 1 2 4 4 4 4 4 4 4 4 4 4 2 1 1 1 1 1 1 2 1 1 1 1 1 2 1 1 1 2 2 2 2 2 1 1 1 1 1 1 2 4 4 4 4 4 2 
0 4 4 4 4 4 4 4 2 2 2 2 1 1 2 2 2 1 1 2 2 2 1 1 1 2 4 4 4 4 4 2 1 1 2 4 4 4 4 4 4 4 4 4 4 2 1 1 1 1 1 2 2 2 1 1 2 2 2 1 1 1 2 1 1 1 1 1 1 1 1 1 1 1 4 4 4 4 4 2 
0 2 2 4 4 2 2 2 2 1 1 1 1 1 1 2 1 1 1 1 1 1 1 1 1 2 4 4 4 4 4 2 1 1 1 4 4 4 4 4 4 4 4 4 4 2 1 1 1 1 1 2 1 1 1 1 1 1 2 1 1 1 2 1 1 1 1 1 1 1 1 1 1 1 4 4 4 4 4 2 
0 4 4 4 4 4 4 4 4 1 1 1 1 1 1 2 1 1 1 1 1 1 1 1 1 2 4 4 4 4 4 2 1 1 1 4 4 4 4 4 4 4 4 4 4 2 1 1 1 1 1 2 1 1 1 1 1 1 2 1 1 1 2 1 1 1 1 2 2 2 1 1 1 2 4 4 2 2 2 2 
2 4 4 4 4 4 4 4 4 1 1 1 1 1 1 2 1 1 1 1 2 1 1 1 1 2 2 2 2 2 2 2 1 1 2 2 2 2 2 2 2 2 2 2 2 2 2 2 2 2 2 2 1 1 1 1 1 1 2 1 1 1 2 1 1 1 1 2 1 1 1 1 1 2 4 4 4 4 4 2 
0 4 4 4 4 2 2 2 2 2 2 1 1 2 2 2 2 2 2 2 2 2 1 1 1 2 1 1 1 1 1 1 1 1 1 1 1 1 1 1 1 1 1 1 1 1 1 1 1 1 1 2 1 1 1 1 1 1 2 1 1 1 2 1 1 1 1 2 1 1 1 1 1 2 4 4 4 4 4 2 
0 4 4 4 4 4 4 4 2 1 1 1 1 1 2 1 1 1 1 1 1 2 1 1 1 2 1 1 1 1 1 1 1 1 1 1 1 1 1 1 1 1 1 1 1 1 1 1 1 1 1 2 2 2 2 1 1 2 2 1 1 1 2 2 2 2 2 2 1 1 1 1 1 2 4 4 4 4 4 2 
2 4 4 4 4 4 4 4 2 1 1 1 1 1 1 1 1 1 1 1 1 2 1 1 1 2 2 2 2 2 2 2 2 2 2 2 2 1 1 1 1 2 2 2 2 2 1 1 1 1 1 2 1 1 1 1 1 1 2 1 1 1 2 1 1 1 1 1 1 1 1 1 1 2 4 4 4 4 4 2 
2 4 4 4 4 4 4 4 2 1 1 1 1 1 1 1 1 1 1 1 1 2 1 1 1 2 1 1 1 1 1 1 1 1 1 1 2 2 2 2 2 2 1 1 1 2 1 1 1 1 1 2 1 1 1 1 1 1 1 1 1 1 2 1 1 1 1 1 1 1 1 1 1 2 2 2 2 2 2 2 
2 4 4 4 4 4 4 4 2 2 2 1 1 2 2 1 1 1 1 1 1 2 1 1 1 2 1 1 1 1 1 1 1 1 1 1 1 1 1 1 1 1 1 1 1 2 1 1 1 1 1 1 1 1 1 1 1 1 1 1 1 1 2 1 1 1 1 1 1 1 1 1 1 1 1 1 1 1 1 2 
2 2 2 4 4 2 2 2 2 1 1 1 1 1 2 2 2 2 2 2 2 2 1 1 1 2 1 1 1 1 1 1 1 1 1 1 1 1 1 1 1 1 1 1 1 2 2 2 2 2 2 2 2 2 2 2 2 2 2 1 1 1 2 2 1 1 2 2 2 2 2 1 1 1 1 1 1 1 1 2 
2 4 4 4 4 4 4 4 2 1 1 1 1 1 2 1 1 1 2 1 1 1 1 1 1 2 1 1 1 1 1 1 1 1 1 1 2 1 1 1 1 1 1 1 1 2 1 1 1 1 1 1 1 1 1 1 1 1 1 1 1 1 2 1 1 1 1 1 1 1 2 1 1 1 1 1 1 1 1 2 
2 4 4 4 4 4 4 4 2 1 1 1 1 1 2 1 1 1 1 1 1 1 1 1 1 2 2 2 2 2 2 2 2 2 2 2 2 1 1 2 2 2 2 2 2 2 1 1 1 1 1 1 1 1 1 1 1 1 1 1 1 1 2 1 1 1 1 1 1 1 2 1 1 1 1 1 1 1 1 2 
2 4 4 4 4 4 4 4 2 2 2 1 1 1 1 1 1 1 1 1 1 1 1 1 1 2 1 1 1 1 1 1 1 1 1 1 1 1 1 1 2 1 1 1 1 2 1 1 1 1 1 1 1 1 1 1 1 1 1 1 1 1 2 1 1 1 1 1 1 1 2 1 1 1 1 1 1 1 1 2 
2 4 4 4 4 4 4 4 2 1 1 1 1 1 1 1 1 1 2 1 1 1 1 1 1 2 1 1 1 1 1 1 1 1 2 1 1 1 1 1 2 1 1 1 1 2 1 1 1 1 1 1 1 1 2 2 2 1 1 2 2 2 2 1 1 1 1 1 1 1 2 1 1 1 1 1 1 1 1 2 
2 2 2 4 4 2 2 2 2 1 1 1 1 1 2 2 2 2 2 2 2 2 1 1 1 2 1 1 1 1 1 1 1 1 2 1 1 1 1 1 2 1 1 1 1 2 1 1 1 1 1 1 1 1 2 1 1 1 1 1 1 1 1 1 1 1 1 1 1 1 2 2 2 1 1 2 2 2 2 2 
2 4 4 4 4 4 4 4 2 1 1 1 1 1 2 1 1 1 1 1 1 2 1 1 1 2 1 1 1 1 1 1 1 1 2 1 1 1 1 1 2 1 1 1 1 2 1 1 1 1 1 1 1 1 2 1 1 1 1 1 1 1 1 1 1 1 1 1 1 1 2 1 1 1 1 2 1 1 1 2 
2 4 4 4 4 4 4 4 2 2 2 2 2 2 2 1 1 1 1 1 1 2 1 1 1 2 2 1 1 1 1 1 1 1 2 1 1 1 1 1 1 1 1 1 2 2 1 1 1 1 1 1 1 1 2 1 1 1 1 1 2 1 1 1 1 1 1 1 1 1 2 1 1 1 1 2 1 1 1 2 
2 4 4 4 4 4 4 4 1 1 1 1 1 1 1 1 1 1 1 1 1 2 1 1 1 1 2 2 2 2 1 1 2 2 2 2 2 2 2 2 2 2 2 2 2 1 1 1 1 1 1 1 1 1 2 1 1 1 1 1 2 2 2 2 2 1 1 2 2 2 2 1 1 1 1 2 1 1 1 2 
2 4 4 4 4 4 4 4 1 1 1 1 1 1 1 1 1 1 1 1 1 2 1 1 1 1 1 1 1 1 1 1 1 1 1 1 1 1 1 1 1 1 1 1 1 1 1 1 1 1 1 1 1 1 2 1 1 1 1 1 2 1 1 1 1 1 1 1 1 1 2 1 1 1 1 2 1 1 1 2 
2 4 4 4 4 4 4 2 2 2 2 2 1 1 2 2 2 1 1 2 2 2 1 1 1 1 1 1 1 1 1 1 1 2 2 2 2 2 2 2 1 1 1 1 1 1 1 1 1 1 1 1 1 1 2 1 1 1 1 1 2 1 1 1 1 1 1 1 1 1 1 1 1 1 1 1 1 1 1 2 
2 2 4 4 2 2 2 2 1 1 1 2 1 1 2 1 1 1 1 1 1 2 1 1 1 1 2 2 2 2 2 2 2 2 4 4 4 4 4 2 1 1 1 1 1 1 1 1 1 1 1 1 1 1 2 1 1 1 1 1 2 1 1 1 1 1 1 1 1 1 1 1 1 1 1 1 1 1 1 2 
2 4 4 4 4 2 1 1 1 1 1 2 1 1 2 1 1 1 1 1 1 2 1 1 1 1 2 4 4 4 4 4 4 2 4 4 4 4 4 1 1 1 1 1 1 1 1 1 1 1 1 1 1 1 2 2 2 2 2 2 2 2 2 2 2 2 2 2 2 2 2 2 2 1 1 2 2 2 2 2 
2 4 4 4 4 2 1 1 1 1 1 2 1 1 2 1 1 1 1 1 1 2 1 1 1 1 2 4 4 4 4 4 4 4 4 4 4 4 4 1 1 1 1 1 1 1 1 1 1 1 1 1 1 1 1 1 1 1 1 1 1 1 1 1 1 1 1 1 1 1 1 1 1 1 1 1 1 1 1 2 
2 4 4 4 4 2 1 1 1 1 1 1 1 1 2 1 1 1 1 1 1 2 1 1 1 1 2 4 4 4 4 4 4 4 4 4 4 4 4 2 1 1 1 1 1 1 1 1 1 1 1 1 1 1 1 1 1 1 1 1 1 1 1 1 1 1 1 1 1 1 1 1 1 1 1 1 1 1 1 2 
2 4 4 4 4 2 1 1 1 1 1 1 1 1 2 1 1 1 1 1 1 1 1 1 1 1 2 2 2 2 2 4 4 2 2 2 2 2 2 2 1 1 1 2 2 1 1 2 2 2 2 2 2 2 2 2 1 1 2 2 1 2 2 1 1 2 2 2 2 1 1 2 2 2 2 2 2 2 2 2 
2 4 4 4 4 2 1 1 2 2 2 2 2 2 2 1 1 1 1 1 1 1 1 1 1 1 2 4 4 4 4 4 4 4 4 4 4 4 2 1 1 1 1 2 1 1 1 1 1 1 1 2 1 1 1 2 1 1 1 2 1 2 1 1 1 1 1 1 2 1 1 2 4 4 4 4 4 4 4 2 
2 4 4 4 4 2 1 1 2 4 4 4 4 4 2 1 1 1 1 1 1 2 1 1 1 1 2 4 4 4 4 4 4 4 4 4 4 4 2 1 1 1 1 2 1 1 1 1 1 1 1 2 1 1 1 2 1 1 1 2 1 2 1 1 1 1 1 1 2 1 1 2 4 4 4 4 4 4 4 2 
2 2 4 4 2 2 2 2 2 4 4 4 4 4 2 2 2 2 2 2 2 2 1 1 1 1 2 2 2 2 2 2 2 2 2 2 2 2 2 1 1 1 1 2 1 1 1 1 1 1 1 2 1 1 1 2 1 1 1 2 1 2 1 1 1 1 1 1 2 1 1 2 4 4 4 4 4 4 4 2 
2 4 4 4 4 4 4 4 2 4 4 4 4 4 1 1 1 1 1 2 1 1 1 1 1 1 1 1 1 1 1 1 1 1 1 1 1 1 1 1 1 1 1 2 2 2 2 2 2 1 1 2 1 1 1 1 1 1 1 2 1 2 2 1 1 2 2 2 2 1 1 2 4 4 2 2 4 4 2 2 
2 4 4 4 4 4 4 4 2 4 4 4 4 4 1 1 1 1 1 2 1 1 1 1 1 1 1 1 1 1 1 1 1 1 1 1 1 1 1 1 1 1 1 2 1 1 1 2 1 1 1 2 1 1 1 1 1 1 1 2 1 2 1 1 1 1 1 1 2 1 1 2 2 2 2 4 4 4 4 2 
2 2 2 2 2 4 4 2 2 4 4 4 4 4 2 1 1 1 1 2 2 2 2 2 2 2 2 2 2 2 2 2 2 2 2 2 2 1 1 1 1 1 1 2 1 1 1 2 1 1 1 2 2 2 2 2 2 1 1 2 1 2 1 1 1 1 1 1 2 1 1 2 4 4 2 4 4 4 4 2 
2 3 3 4 4 4 4 4 2 2 2 4 4 2 2 1 1 1 1 1 1 1 1 1 1 1 1 1 2 1 1 1 1 1 1 1 1 1 1 1 1 1 1 2 1 1 1 2 1 1 1 2 1 1 1 1 1 1 1 2 1 2 1 1 1 1 1 1 1 1 1 2 4 4 2 4 4 3 3 2 
2 3 3 4 4 4 4 4 4 4 4 4 4 4 2 1 1 1 1 1 1 1 1 1 1 1 1 1 1 1 1 1 1 1 1 1 1 4 4 4 4 4 4 2 1 1 1 1 1 1 1 1 1 1 1 1 1 1 1 2 1 2 1 1 1 1 1 1 1 1 1 1 4 4 4 4 4 3 3 2 
2 3 3 4 4 4 4 4 4 4 4 4 4 4 2 1 1 1 1 2 1 1 1 1 1 1 1 1 1 1 1 1 1 1 1 1 2 4 4 3 3 4 4 2 1 1 1 1 1 1 1 1 1 1 1 1 1 1 1 2 1 2 1 1 1 1 1 1 2 1 1 1 4 4 4 4 4 3 3 2 
2 2 2 2 2 2 2 2 2 2 2 2 2 2 2 2 2 2 2 2 2 2 2 2 2 2 2 2 2 2 2 2 2 2 2 2 2 2 2 2 0 2 2 2 2 2 2 2 2 2 2 2 2 2 2 2 2 2 2 2 2 2 2 2 2 2 2 2 2 2 2 2 2 2 2 2 2 2 2 2 
