0 2 2 2 2 2 2 2 2 2 2 2 2 2 2 2 2 2 2 2 2 2 2 2 2 2 2 2 2 2 2 2 2 2 2 2 2 2 2 2 2 2 2 2 2 2 2 2 2 2 0 2 2 2 2 2 2 2 2 2 2 2 2 2 2 2 2 2 2 2 2 2 2 2 2 2 2 2 2 2 
0 31 32 32 30 21 23 23 23 23 23 21 25 25 22 22 22 22 22 21 22 22 22 22 25 25 21 20 20 20 20 20 21 22 22 24 24 24 22 22 21 28 29 32 30 21 22 24 24 24 22 22 22 21 20 3 3 20 20 21 23 23 23 23 23 23 23 21 25 25 22 24 24 24 22 21 23 23 23 2 
0 32 32 32 32 21 23 23 23 23 23 21 26 26 22 22 22 22 22 21 22 22 22 22 26 26 21 20 20 20 20 20 21 22 22 22 22 22 22 22 21 32 32 32 32 21 22 22 22 22 22 22 22 21 20 20 20 20 20 23 23 23 23 33 33 23 23 21 26 26 22 22 22 22 22 22 23 23 23 2 
2 32 32 32 32 21 23 23 23 23 23 21 26 26 22 22 22 22 22 21 22 22 22 22 26 26 21 20 20 20 20 20 21 22 22 22 22 22 22 22 21 32 32 32 32 21 22 22 22 22 22 22 22 21 20 20 20 20 20 23 23 23 34 33 33 34 23 21 26 26 22 22 22 22 22 22 23 23 23 2 
2 32 32 32 32 23 23 23 23 23 23 21 22 22 22 22 22 22 22 21 22 22 22 22 22 22 21 20 20 20 20 20 21 22 22 33 33 33 22 22 21 31 32 32 32 21 22 22 22 22 22 22 22 21 20 20 20 20 20 21 23 23 23 33 33 23 23 21 22 22 22 22 22 22 22 21 23 23 23 2 
2 28 29 32 32 23 23 23 23 23 23 21 22 22 22 22 22 22 22 21 22 22 22 22 22 22 21 20 20 20 20 20 21 22 34 33 33 33 34 22 21 21 32 32 21 21 22 22 22 22 22 22 22 21 20 20 20 20 20 21 23 23 23 23 23 23 23 21 21 21 21 21 21 21 21 21 23 23 23 2 
2 21 21 21 21 21 23 23 23 23 23 21 22 22 22 22 22 22 22 21 22 22 22 22 22 22 21 20 20 20 20 20 21 22 22 33 33 33 22 22 22 22 22 22 22 22 22 22 22 22 22 22 22 21 20 20 20 20 20 21 23 23 23 23 23 23 23 21 23 23 23 23 23 23 23 23 23 23 23 2 
2 24 24 24 24 21 23 23 23 23 23 21 27 27 22 22 22 22 22 21 27 27 22 22 22 22 21 20 20 20 20 20 21 22 22 22 22 22 22 22 22 22 22 22 22 22 22 22 22 22 22 22 22 21 20 20 20 20 20 21 21 21 21 23 23 21 21 21 23 23 23 23 23 23 23 23 23 23 23 2 
2 23 23 23 23 21 23 23 23 23 23 21 21 21 21 23 23 21 21 21 21 21 23 23 21 21 21 20 20 20 20 20 21 22 22 22 22 22 22 22 22 22 22 22 22 22 22 22 22 22 22 22 22 21 20 20 20 20 20 21 23 23 23 23 23 23 23 23 23 23 23 23 23 23 23 23 23 23 23 2 
2 23 23 23 23 21 23 23 23 23 23 23 23 23 23 23 23 34 33 33 33 34 23 23 23 23 21 20 20 20 20 20 21 21 21 21 21 21 21 21 21 21 21 21 21 21 21 22 22 22 21 21 21 21 20 20 20 20 20 21 23 23 23 23 23 23 23 23 23 23 21 21 21 21 21 21 21 21 21 2 
2 23 23 23 23 21 23 23 23 23 23 23 23 23 23 23 23 23 33 33 33 23 23 23 23 23 21 20 20 20 20 20 21 25 26 26 23 26 26 25 21 22 22 22 22 22 22 22 22 22 22 22 22 21 20 20 20 20 20 21 23 23 23 23 23 23 23 23 23 23 21 20 20 20 20 20 20 20 20 2 
2 23 23 23 23 21 21 21 23 23 23 23 23 23 23 23 23 23 23 23 23 23 23 23 23 23 21 20 20 20 20 20 21 25 26 26 23 26 26 25 21 22 22 22 22 22 22 22 22 22 22 22 22 21 20 20 20 20 20 21 21 21 21 21 21 21 21 21 21 21 21 20 20 20 20 20 20 20 20 2 
2 23 23 23 23 23 23 23 23 23 23 21 23 23 23 23 23 23 23 23 23 23 23 23 23 23 21 20 20 20 20 20 21 23 23 23 23 23 23 23 21 22 22 22 22 22 22 22 22 22 22 22 22 21 20 20 20 20 20 20 20 20 20 20 20 20 20 20 20 20 20 20 20 20 20 20 20 20 20 2 
2 23 23 23 23 23 23 23 23 23 23 21 23 23 23 23 23 23 23 23 23 23 23 23 23 23 21 20 20 20 20 20 21 23 23 23 23 23 23 23 21 22 22 22 22 22 22 33 33 33 22 22 22 21 20 20 20 20 20 20 20 20 20 20 20 20 20 20 20 20 20 20 20 20 20 20 20 20 20 2 
2 23 23 23 23 23 23 23 23 23 23 21 27 27 23 23 23 23 23 23 23 23 23 23 27 27 21 20 20 20 20 20 21 23 23 23 23 23 23 23 21 22 22 22 22 22 34 33 33 33 34 22 22 21 20 20 20 20 20 20 20 20 20 20 20 20 20 20 20 20 20 20 20 20 20 20 20 20 20 2 
2 21 21 21 21 21 21 21 21 21 21 21 21 21 21 21 21 21 20 20 21 21 21 21 21 21 21 20 20 20 20 20 21 23 23 23 23 23 23 23 21 22 22 22 22 22 22 33 33 33 22 22 22 21 20 20 20 20 20 20 20 20 20 20 20 20 20 20 20 20 20 20 20 20 20 20 20 20 20 2 
2 20 20 20 20 20 20 20 20 20 20 20 20 20 20 20 20 20 20 20 20 20 20 20 20 20 20 20 20 20 20 20 21 23 23 23 23 23 23 23 21 22 22 22 22 22 22 22 22 22 22 22 22 21 20 20 20 20 20 20 20 20 20 20 20 20 20 20 20 20 20 20 20 20 20 20 20 20 20 2 
2 20 20 20 20 20 20 20 20 20 20 20 20 20 20 20 20 20 20 20 20 20 20 20 20 20 20 20 20 20 20 20 21 23 23 23 23 23 23 23 23 22 22 22 22 22 22 22 22 22 22 22 22 21 20 20 20 20 20 20 20 20 20 20 20 20 20 20 20 20 20 20 20 20 20 20 20 20 20 2 
2 20 20 20 20 20 20 20 20 20 20 20 20 20 20 20 20 20 20 20 20 20 20 20 20 20 20 20 20 20 20 20 21 23 23 27 27 27 23 23 23 22 22 22 22 22 22 22 22 22 22 22 22 21 20 20 20 20 20 20 20 20 20 20 20 20 20 20 20 20 20 20 20 20 20 20 20 20 20 2 
2 20 20 20 20 20 20 20 20 20 20 20 20 20 20 20 20 20 20 20 20 20 20 20 20 20 20 20 20 20 20 20 21 21 21 21 21 21 21 21 21 22 22 21 21 21 21 21 21 21 21 21 21 21 20 20 20 20 20 20 20 20 20 20 20 20 20 20 20 20 20 20 20 20 20 20 20 20 20 2 
2 20 20 20 20 20 20 20 20 20 20 20 20 20 20 20 20 20 20 20 20 20 20 20 20 20 20 20 20 20 20 20 20 20 20 20 20 20 20 20 20 20 20 20 20 20 20 20 20 20 20 20 20 20 20 20 20 20 20 20 20 20 20 20 20 20 20 20 20 20 20 20 20 20 20 20 20 20 20 2 
2 20 20 20 20 20 20 20 20 20 20 20 20 20 20 20 20 20 20 20 20 20 20 20 20 20 20 20 20 20 20 20 20 20 20 20 20 20 20 20 20 20 20 20 20 20 20 20 20 20 20 20 20 20 20 20 20 20 20 20 20 20 20 20 20 20 20 20 20 20 20 20 20 20 20 20 20 20 20 2 
2 20 20 20 20 20 20 20 20 20 20 20 20 20 20 20 20 20 20 20 20 20 20 20 20 20 20 20 20 20 20 20 20 20 20 20 20 20 20 20 20 20 20 20 20 20 20 20 20 20 20 20 20 20 20 20 20 20 20 20 20 20 20 20 20 20 20 20 20 20 20 20 20 20 20 20 20 20 20 2 
2 20 20 20 20 20 20 20 20 20 20 20 20 20 20 20 20 20 20 20 20 20 20 20 20 20 20 20 20 20 20 20 20 20 20 20 20 20 20 20 20 20 20 20 20 20 20 20 20 20 20 20 20 20 20 20 20 20 20 20 20 20 20 20 20 20 20 20 20 20 20 20 20 20 20 20 20 20 20 2 
2 20 20 20 20 20 20 20 20 20 20 20 20 20 20 20 20 20 20 20 20 20 20 20 20 20 20 20 20 20 20 20 20 20 20 20 20 20 20 20 21 21 21 21 21 21 21 21 21 21 21 20 20 20 20 20 20 20 20 20 20 20 20 20 20 20 20 20 20 20 20 20 20 20 20 20 20 20 20 2 
2 20 20 20 20 20 20 20 20 20 20 20 20 20 20 20 20 20 20 20 20 20 20 20 20 20 20 20 20 20 20 20 20 20 20 20 20 20 20 20 21 22 22 22 22 21 23 24 24 23 21 20 20 20 20 20 20 20 20 20 20 20 20 20 20 20 20 20 20 20 20 20 20 20 20 20 20 20 20 2 
2 20 20 20 20 20 20 20 20 20 20 20 20 20 20 20 20 20 20 20 20 20 20 20 20 20 20 20 20 20 20 20 20 20 20 20 20 20 20 20 21 22 22 22 22 21 23 23 23 23 21 20 20 20 20 20 20 20 20 20 20 20 20 20 20 20 20 20 20 20 20 20 20 20 20 20 20 20 20 2 
2 20 20 20 20 20 20 20 20 20 20 20 20 20 20 20 20 20 20 20 20 20 20 20 20 20 20 20 20 20 20 20 20 20 20 20 20 20 20 20 21 22 22 22 22 21 23 23 23 23 21 20 20 20 20 20 20 20 20 20 20 20 20 20 20 20 20 20 20 20 20 20 20 21 21 21 21 21 21 2 
2 21 21 21 21 21 21 21 21 21 21 21 21 21 21 21 21 21 21 21 21 21 21 21 21 21 21 21 21 20 20 20 20 20 20 20 20 20 20 20 21 22 22 22 22 22 23 23 23 23 21 21 21 21 21 21 21 21 21 21 21 20 20 20 20 20 20 20 20 20 20 20 20 21 25 25 22 22 31 2 
2 30 31 32 21 23 23 23 21 25 25 24 24 24 22 22 34 21 23 23 23 23 23 23 23 23 23 31 21 20 20 20 20 20 20 20 20 20 20 20 22 22 22 22 22 22 23 23 23 23 23 23 23 23 23 23 23 23 23 23 21 20 20 20 20 20 20 20 20 20 20 20 20 21 26 26 22 22 22 2 
2 32 32 32 23 23 23 23 21 26 26 22 22 22 22 22 22 21 23 23 23 23 23 23 23 23 23 23 21 20 20 20 20 20 20 20 20 20 20 20 22 22 22 22 22 21 23 23 23 23 23 23 23 23 23 23 23 23 23 23 21 20 20 20 20 20 20 21 21 21 21 21 21 21 26 26 22 22 22 2 
2 32 32 32 23 23 23 23 21 26 26 22 22 22 22 22 22 21 23 23 23 34 23 23 34 23 23 23 21 20 20 20 20 20 20 20 20 20 20 20 21 21 21 21 21 21 23 23 23 23 21 23 23 23 23 23 23 23 23 23 21 20 20 20 20 20 20 21 34 33 33 33 34 21 22 22 22 22 22 2 
2 28 29 32 21 23 23 23 21 22 22 22 22 22 22 22 22 21 23 23 23 33 33 33 33 23 23 23 21 20 20 20 20 20 20 20 20 20 20 20 21 25 25 22 34 21 21 21 21 21 21 23 23 23 23 23 23 23 23 23 21 20 20 20 20 20 20 21 22 33 33 33 22 21 22 22 22 22 22 2 
2 21 21 21 21 23 23 23 21 22 22 22 22 22 22 22 22 21 23 23 23 33 33 33 33 23 23 23 20 20 20 20 20 20 20 20 20 20 20 20 21 26 26 22 22 22 22 23 23 23 21 23 23 23 23 23 23 23 23 23 21 20 20 20 20 20 20 21 22 22 22 22 22 21 22 22 22 22 22 2 
2 23 23 23 23 23 23 23 21 21 21 21 21 21 21 22 22 21 23 23 23 33 33 33 33 23 23 23 20 20 20 20 20 20 20 20 20 20 20 20 21 26 26 22 22 22 22 23 23 23 21 21 21 21 23 23 21 21 21 21 21 20 20 20 20 20 20 21 22 22 22 22 22 21 21 21 22 22 21 2 
2 23 23 23 23 23 23 23 21 34 22 22 22 22 22 22 22 21 23 23 23 33 33 33 33 23 23 23 21 20 20 20 20 20 20 20 20 20 20 20 21 22 22 22 22 22 22 23 23 23 23 23 23 23 23 23 23 23 23 23 21 20 20 20 20 20 20 22 22 22 22 22 22 22 22 22 22 22 22 2 
2 23 23 23 23 23 23 23 22 22 22 22 22 22 22 22 22 22 23 23 23 34 23 23 34 23 23 23 21 20 20 20 20 20 20 20 20 20 20 20 21 22 22 22 22 22 21 23 23 23 23 23 23 23 23 23 23 23 23 23 21 20 20 20 20 20 20 22 22 22 22 22 22 22 22 22 22 22 22 2 
2 23 23 33 33 33 23 23 22 22 22 22 22 22 22 22 22 22 23 23 23 23 23 23 23 23 23 23 21 20 20 20 20 20 20 20 20 20 20 20 21 22 22 22 22 22 21 23 23 23 23 23 23 33 33 33 33 23 23 23 21 20 20 20 20 20 20 21 22 22 22 22 22 21 22 22 22 22 22 2 
2 23 34 33 33 33 34 23 21 22 22 27 27 27 22 22 22 21 23 23 23 23 23 23 23 23 23 23 21 20 20 20 20 20 20 20 20 20 20 20 21 27 27 27 22 22 21 23 23 23 23 23 34 33 33 33 33 34 23 23 21 20 20 3 3 20 20 21 22 27 27 27 22 21 22 22 22 22 22 2 
2 2 2 2 2 2 2 2 2 2 2 2 2 2 2 2 2 2 2 2 2 2 2 2 2 2 2 2 2 2 2 2 2 2 0 2 2 2 2 2 2 2 2 2 2 2 2 2 2 2 2 2 2 2 2 2 2 2 2 2 2 2 2 2 2 2 2 2 2 2 2 2 2 2 2 2 2 2 2 2 
