0 0 0 0 0 0 0 0 0 2 0 0 0 0 0 0 0 0 0 0 0 0 0 2 0 0 0 0 0 0 0 0 0 0 0 0 0 0 0 0 0 0 0 0 0 0 0 0 0 0 0 0 0 0 0 0 0 0 0 0 0 0 0 0 0 0 0 0 0 0 0 0 0 0 0 0 0 0 0 0 
0 25 25 23 23 23 23 23 23 24 24 24 23 21 23 23 34 33 33 33 34 23 23 23 34 33 33 33 34 23 21 20 20 20 20 20 20 20 20 20 20 20 20 21 32 32 32 32 21 25 25 22 34 34 21 23 34 33 33 34 23 21 20 20 20 20 20 20 20 20 20 20 21 25 25 23 23 23 34 0 
0 26 26 23 23 23 23 23 23 23 23 23 23 21 23 23 23 33 33 33 23 23 23 23 23 33 33 33 23 23 21 20 20 20 20 20 20 20 20 20 20 20 20 21 32 32 32 32 21 26 26 22 22 22 21 23 23 33 33 23 23 21 20 20 20 20 20 20 20 20 20 20 21 26 26 23 23 33 33 0 
0 26 26 23 23 23 23 23 23 23 23 23 23 21 23 23 23 23 23 23 23 23 23 23 23 23 23 23 23 23 21 20 20 20 20 20 20 20 20 20 20 20 20 21 32 32 32 32 21 26 26 22 22 22 23 23 23 23 23 23 23 21 20 20 20 20 20 20 20 20 20 20 21 26 26 23 23 33 33 0 
0 23 23 23 23 23 23 23 23 23 23 23 23 23 23 23 23 23 23 23 23 23 23 23 23 23 23 23 23 23 21 20 20 20 20 20 20 20 20 20 20 20 20 21 32 32 32 32 21 22 22 22 22 22 23 23 23 23 23 23 23 21 20 20 20 20 20 20 20 20 20 20 21 23 23 23 23 23 34 0 
0 23 23 23 23 23 23 23 23 23 23 23 23 23 23 23 23 23 23 23 23 23 23 23 23 23 23 23 23 23 21 20 20 20 20 20 20 20 20 20 20 20 20 21 21 23 23 21 21 22 22 22 22 22 21 23 23 23 23 23 23 20 20 20 20 20 20 20 20 20 20 20 21 27 27 23 23 23 23 0 
0 21 21 21 22 22 21 21 23 23 23 23 23 21 21 21 21 21 21 22 22 22 21 21 21 32 32 32 21 21 21 20 20 20 20 20 20 20 20 20 20 20 20 21 23 23 23 23 21 21 21 21 21 21 21 23 23 23 23 23 23 20 20 20 20 20 20 20 20 20 20 20 21 21 21 23 23 21 21 0 
0 34 22 22 22 22 22 21 23 23 23 23 23 21 24 24 24 22 22 22 22 22 21 30 32 32 32 32 31 31 21 20 20 20 20 20 20 20 20 20 20 20 20 21 23 23 23 23 23 23 23 23 23 23 23 23 23 23 23 23 23 20 20 20 20 20 20 20 20 20 20 20 20 20 20 20 20 20 20 0 
0 33 33 22 22 22 22 21 23 23 23 23 23 21 22 22 22 22 22 22 22 22 21 32 32 32 32 32 32 32 21 20 20 20 20 20 20 20 20 20 20 20 20 21 23 23 23 23 23 23 23 23 23 23 23 23 23 23 23 23 23 21 20 20 20 20 20 20 20 20 20 20 20 20 20 20 20 20 20 0 
0 33 33 22 22 22 22 21 23 23 34 23 23 21 22 22 22 22 22 22 22 22 21 32 32 32 32 32 32 32 21 20 20 20 20 20 20 20 20 20 20 20 20 21 23 23 23 23 23 23 34 23 23 34 23 23 23 23 23 23 23 21 20 20 20 20 20 20 20 20 20 20 20 20 20 20 20 20 20 0 
0 33 33 22 22 22 22 21 23 33 33 33 23 21 25 26 26 22 22 22 22 22 21 32 32 32 32 32 32 32 21 20 20 20 20 20 20 20 20 20 20 20 20 21 23 23 23 23 23 33 33 33 33 33 33 23 23 23 23 23 23 21 20 20 20 20 20 20 20 20 20 20 20 20 20 20 20 20 20 0 
0 34 22 22 22 22 22 21 23 33 33 33 23 21 25 26 26 22 22 22 22 22 21 32 32 32 28 29 32 32 21 20 20 20 20 20 20 20 20 20 20 20 20 21 23 23 23 23 23 33 33 33 33 33 33 23 27 27 27 27 23 21 20 20 20 20 20 20 20 20 20 20 20 20 20 20 20 20 20 0 
0 21 21 21 20 20 21 21 21 21 21 21 21 21 21 21 21 21 21 21 21 21 21 21 21 21 21 21 21 21 21 20 20 20 20 20 20 20 20 20 20 20 20 21 21 21 21 21 21 21 21 21 21 21 21 21 21 21 21 21 21 21 20 20 20 20 20 20 20 20 20 20 20 20 20 20 20 20 20 0 
0 3 3 20 20 20 20 20 20 20 20 20 20 20 20 20 20 20 20 20 20 20 20 20 20 20 20 20 20 20 20 20 20 20 20 20 20 20 20 20 20 20 20 20 20 20 20 20 20 20 20 20 20 20 20 20 20 20 20 20 20 20 20 20 20 20 20 20 20 20 20 20 20 20 20 20 20 20 20 0 
0 3 3 20 20 20 20 20 20 20 20 20 20 20 20 20 20 20 20 20 20 20 20 20 20 20 20 20 20 20 20 20 20 20 20 20 20 20 20 20 20 20 20 20 20 20 20 20 20 20 20 20 20 20 20 20 20 20 20 20 20 20 20 20 20 20 20 20 20 20 20 20 20 20 20 20 20 20 20 0 
0 3 3 20 20 20 20 20 20 20 20 20 20 20 20 20 20 20 20 20 20 20 20 20 20 20 20 20 20 20 20 20 20 20 20 20 20 20 20 20 20 20 20 20 20 20 20 20 20 20 20 20 20 20 20 20 20 20 20 20 20 20 20 20 20 20 20 20 20 20 20 20 20 20 20 20 20 20 20 0 
0 21 21 21 21 21 21 21 21 21 20 20 20 20 20 20 20 20 20 20 20 20 20 20 20 20 20 20 20 20 20 20 20 20 20 20 20 20 20 20 20 20 20 20 20 20 20 20 20 20 20 20 20 20 20 20 20 20 20 20 20 20 20 20 20 20 20 20 20 20 20 20 20 20 20 20 20 20 20 0 
0 25 26 26 22 22 22 22 34 21 20 20 20 20 20 20 20 20 20 20 20 20 21 21 21 21 21 21 21 21 21 21 21 21 21 21 21 21 21 20 20 20 20 20 20 20 20 20 20 20 20 20 20 20 20 20 20 20 20 20 20 20 20 20 20 20 20 20 20 20 20 20 20 20 20 20 20 20 20 0 
0 25 26 26 22 22 33 33 33 21 20 20 20 20 20 20 20 20 20 20 20 20 21 25 26 26 23 23 23 23 21 22 22 24 24 24 22 22 21 20 20 20 20 20 20 20 20 20 20 20 20 20 20 20 20 20 20 20 20 20 20 20 20 20 20 20 20 20 20 20 20 20 20 20 20 20 20 20 20 0 
0 22 22 22 22 22 33 33 33 21 20 20 20 20 20 20 20 20 20 20 20 20 21 25 26 26 23 23 23 23 21 22 22 22 22 22 22 22 21 20 20 20 20 20 20 20 20 20 20 20 20 20 20 20 20 20 20 20 20 20 20 20 20 20 20 20 20 20 20 20 20 20 20 20 20 20 20 20 20 0 
0 22 22 22 22 22 22 22 34 21 20 20 20 20 20 20 20 20 20 20 20 20 21 23 23 23 23 23 23 23 21 22 22 22 34 22 22 22 21 20 20 20 20 20 20 20 20 20 20 20 20 20 20 20 20 20 20 20 20 20 20 20 20 20 20 20 20 20 20 20 20 20 20 20 20 20 20 20 20 2 
0 22 22 22 22 22 22 22 22 21 20 20 20 20 20 20 20 20 20 20 20 20 21 23 23 23 23 23 23 23 21 22 22 33 33 33 22 22 20 20 20 20 20 20 20 20 20 20 20 20 20 20 20 20 20 20 20 20 20 20 20 20 20 20 20 20 20 20 20 20 20 20 20 20 20 20 20 20 20 0 
0 27 27 27 22 22 22 22 22 21 20 20 20 20 20 20 20 20 20 20 20 20 21 21 21 21 21 22 22 21 21 22 22 33 33 33 22 22 20 20 20 20 20 20 20 20 20 20 20 20 20 20 20 20 20 20 20 20 20 20 20 20 20 20 20 20 20 20 20 20 20 20 20 20 20 20 20 20 20 0 
0 21 21 21 21 21 22 22 22 21 20 20 20 20 20 20 20 20 20 20 20 20 21 25 26 26 22 22 22 22 22 22 22 33 33 33 22 22 21 20 20 20 20 20 20 20 20 20 20 20 20 20 20 20 20 20 20 20 20 20 20 20 20 20 20 20 20 20 20 20 20 20 20 20 20 20 20 20 20 0 
0 32 30 31 32 21 22 22 22 21 20 20 20 20 20 20 20 20 20 20 20 20 21 25 26 26 22 22 22 22 22 22 22 22 34 22 22 22 21 20 20 20 20 20 20 21 21 21 21 21 21 21 21 21 21 21 21 21 21 21 21 20 20 20 20 21 21 21 21 21 21 21 21 21 21 21 21 21 21 0 
0 32 32 32 32 22 22 22 22 21 20 20 20 20 20 20 20 20 20 20 20 20 21 22 22 22 22 22 22 22 21 22 22 22 22 22 22 22 21 20 20 20 20 20 20 21 23 24 24 24 24 23 21 22 22 22 22 22 31 31 21 20 20 20 20 21 32 32 32 30 32 31 21 23 23 23 23 23 23 0 
0 32 32 32 32 22 22 22 22 21 20 20 20 20 20 20 20 20 20 20 20 20 21 22 22 22 22 22 22 22 21 22 22 27 27 27 22 22 21 20 20 20 20 20 20 21 23 23 23 23 23 23 21 22 22 22 34 22 22 22 21 20 20 20 20 21 32 32 32 32 32 32 21 23 34 33 33 34 23 0 
0 28 29 32 32 21 22 22 22 21 20 20 20 20 20 20 20 20 20 20 20 20 21 21 21 21 21 21 21 21 21 21 21 21 21 21 21 21 21 20 20 20 20 20 20 21 23 23 23 23 23 23 21 22 22 33 33 33 22 22 21 20 20 20 20 21 32 32 32 32 32 32 21 23 23 33 33 23 23 0 
0 21 21 21 21 21 22 22 21 21 20 20 20 20 20 20 20 20 20 20 20 20 20 20 20 20 20 20 20 20 20 20 20 20 20 20 20 20 20 20 20 20 20 20 20 21 23 23 23 23 23 23 21 22 22 33 33 33 22 22 21 20 20 20 20 21 32 32 32 32 32 32 23 23 23 33 33 23 23 0 
0 23 23 23 23 23 23 23 23 21 20 20 20 20 20 20 20 20 20 20 20 20 20 20 20 20 20 20 20 20 20 20 20 20 20 20 20 20 20 20 20 20 20 20 20 21 23 23 23 23 23 23 21 22 22 22 34 22 22 22 21 20 20 20 20 21 32 32 32 32 32 32 23 23 34 33 33 34 23 0 
0 23 23 23 34 34 23 23 23 21 20 20 20 20 20 20 20 20 20 20 20 20 20 20 20 20 20 20 20 20 20 20 20 20 20 20 20 20 20 20 20 20 20 20 20 21 23 23 23 23 23 23 21 22 22 22 22 22 22 22 21 20 20 20 20 21 32 28 29 32 32 32 21 23 23 23 23 23 23 0 
0 23 23 33 33 33 33 23 23 21 20 20 20 20 20 20 20 20 20 20 20 20 21 21 21 21 21 21 21 21 21 21 21 21 21 20 20 20 20 20 20 20 20 20 20 21 23 23 23 23 23 23 21 21 21 21 22 22 21 21 21 20 20 20 20 21 21 21 21 21 21 21 21 23 23 23 23 23 23 0 
0 23 23 33 33 33 33 23 23 21 20 20 20 20 20 20 20 20 20 20 20 20 21 25 26 26 23 23 21 28 29 32 30 31 21 20 20 20 20 20 20 20 20 20 20 21 25 26 26 23 23 23 21 23 23 23 23 23 23 23 21 20 20 20 20 21 34 24 24 24 24 22 21 23 23 23 23 23 23 0 
0 23 23 33 33 33 33 23 23 21 20 20 20 20 20 20 20 20 20 20 20 20 21 25 26 26 23 23 21 32 32 32 32 32 21 20 20 20 20 20 20 20 20 20 20 21 25 26 26 23 23 23 21 23 23 23 23 23 23 23 21 20 20 20 20 21 22 22 22 22 22 22 21 23 23 23 23 23 23 0 
0 23 23 33 33 33 33 23 23 21 20 20 20 20 20 20 20 20 20 20 20 20 21 23 23 23 23 23 21 32 32 32 32 32 21 20 20 20 20 20 20 20 20 20 20 21 23 23 23 23 23 23 23 23 23 23 23 23 23 23 23 20 20 20 20 22 22 22 22 22 22 22 22 23 23 23 23 23 23 0 
0 23 23 33 33 33 33 23 23 20 20 20 20 20 20 20 20 20 20 20 20 20 23 23 23 23 23 23 21 21 21 21 32 32 21 20 20 20 20 20 20 20 20 20 20 21 23 23 23 23 23 23 23 23 23 23 23 23 23 23 23 20 20 20 20 22 22 22 22 22 22 22 22 23 23 23 23 23 23 0 
0 23 23 33 33 33 33 23 23 20 20 20 20 20 20 20 20 20 20 20 20 20 23 23 23 23 23 23 23 23 23 23 23 23 21 20 20 20 20 20 20 20 20 20 20 21 23 23 23 23 23 23 21 23 23 23 23 23 23 23 21 20 20 20 20 21 22 22 22 22 22 22 21 23 23 23 23 23 23 0 
0 23 23 23 34 34 23 23 23 21 20 20 20 20 20 20 20 20 20 20 20 20 21 23 23 23 23 23 23 23 23 23 23 23 21 20 20 20 20 3 3 20 20 20 20 21 25 26 26 23 23 23 21 23 23 23 23 23 23 23 21 3 3 3 3 21 22 22 22 26 26 25 21 23 23 23 23 23 23 0 
0 23 23 23 23 23 23 23 23 21 20 20 20 20 3 3 3 3 20 20 20 20 21 23 23 34 33 33 33 33 34 23 23 23 21 20 20 20 20 3 3 20 20 20 20 21 25 26 26 23 23 23 21 23 23 27 27 27 23 23 21 3 3 3 3 21 22 22 22 26 26 25 21 23 27 27 27 27 23 0 
0 0 0 0 0 0 0 2 0 0 0 0 0 0 0 0 0 0 0 0 0 0 0 0 0 0 0 0 0 0 0 0 0 0 0 0 0 0 0 0 0 0 0 0 0 0 0 0 0 0 0 0 0 0 0 0 0 0 0 0 0 0 0 0 0 0 0 0 0 0 0 0 0 0 0 0 0 0 0 0 
