0 0 0 0 0 0 0 0 0 0 0 0 0 0 0 0 0 0 0 0 0 0 0 0 0 0 0 0 0 0 0 0 0 0 0 0 0 0 0 0 0 0 0 0 0 0 0 0 0 0 0 0 0 0 0 0 0 0 0 0 0 0 0 0 0 0 0 0 0 0 0 0 0 0 0 0 0 0 0 0 
0 31 22 22 22 24 24 21 23 23 23 21 23 23 23 23 23 21 23 23 24 24 24 24 24 21 25 25 23 23 23 23 21 28 29 32 30 31 21 20 20 20 20 20 21 23 34 33 33 33 34 23 21 20 20 20 20 20 20 21 25 25 23 23 23 25 25 23 23 23 23 23 21 28 29 32 32 30 31 0 
0 22 22 22 22 22 22 21 23 23 23 21 23 23 23 23 23 21 23 23 23 23 23 23 23 21 26 26 23 23 23 23 21 32 32 32 32 32 21 20 20 20 20 20 21 23 23 33 33 33 23 23 21 20 20 20 20 20 20 21 26 26 23 23 23 26 26 23 23 23 23 23 21 32 32 32 32 32 32 0 
0 22 22 22 22 22 22 21 23 23 23 21 23 23 23 23 23 21 23 23 23 23 23 23 23 21 26 26 23 23 23 23 21 32 32 32 32 32 21 20 20 20 20 20 21 23 23 23 23 23 23 23 21 20 20 20 20 20 20 21 26 26 23 23 23 26 26 23 23 23 23 23 21 32 32 32 32 32 32 0 
0 22 22 22 22 22 22 23 23 23 23 23 23 23 23 23 23 21 23 23 23 23 23 23 23 21 23 23 23 23 23 23 21 32 32 32 32 32 21 20 20 20 20 20 21 23 23 23 23 23 23 23 21 20 20 20 20 20 20 21 23 23 23 23 23 23 23 23 23 23 23 23 21 32 32 32 32 32 32 2 
0 22 22 22 22 22 22 23 23 23 23 23 23 23 23 23 23 21 23 23 23 23 23 23 23 21 23 23 23 23 23 23 21 32 32 32 32 32 21 20 20 20 20 20 21 23 23 23 23 23 23 23 21 20 20 20 20 20 20 21 21 21 21 21 21 21 21 21 21 23 23 23 21 32 32 32 32 32 32 0 
0 22 22 22 26 26 25 21 23 23 23 21 21 23 23 21 21 21 21 21 21 23 23 23 21 21 21 21 21 23 23 21 21 21 21 21 23 23 21 20 20 20 20 20 21 23 23 23 23 23 23 23 20 20 20 20 20 20 20 20 23 23 23 23 23 23 23 23 23 23 23 23 21 32 32 32 32 32 32 0 
0 22 22 22 26 26 25 21 23 23 23 21 22 22 22 22 22 22 22 22 22 22 22 22 22 21 24 24 24 23 23 23 23 23 23 23 23 23 21 20 20 20 20 20 21 23 23 23 23 23 23 23 20 20 20 20 20 20 20 20 23 23 23 23 23 23 23 23 23 23 23 23 21 32 32 32 32 32 32 0 
0 21 21 21 21 21 21 21 23 23 23 21 22 22 22 22 34 22 22 22 34 22 22 22 22 21 23 23 23 23 23 23 34 23 23 23 23 23 21 20 20 20 20 20 21 23 23 23 23 23 23 23 20 20 20 20 20 20 20 20 23 23 23 23 23 23 23 23 23 23 23 23 21 32 32 32 32 32 32 0 
0 22 22 22 26 26 25 21 23 23 23 21 22 22 22 33 33 33 33 33 33 33 22 22 22 21 23 23 23 23 23 33 33 33 23 23 23 23 21 20 20 20 20 20 21 23 23 23 23 23 23 23 21 20 20 20 20 20 20 21 22 22 22 22 21 21 21 21 21 21 21 21 21 21 21 32 32 21 21 0 
0 22 22 22 22 22 22 23 23 23 23 23 22 22 22 33 33 33 33 33 33 33 22 22 22 23 23 23 23 23 23 33 33 33 23 23 23 23 21 20 20 20 20 20 21 23 23 23 23 23 23 23 21 20 20 20 20 20 20 21 22 22 22 22 33 33 33 34 22 22 34 33 33 33 22 22 22 22 22 0 
0 22 22 22 22 22 22 23 23 23 23 23 22 22 22 33 33 33 33 33 33 33 22 22 22 23 23 23 23 23 23 33 33 33 23 23 23 23 21 20 20 20 20 20 21 23 23 23 23 26 26 25 21 20 20 20 20 20 20 21 22 22 22 22 33 33 33 22 22 22 22 33 33 33 22 22 22 22 22 0 
0 22 22 22 22 22 22 21 23 23 23 21 22 22 22 22 34 22 22 22 34 22 22 22 22 21 23 23 23 23 23 23 34 23 23 23 23 23 21 20 20 20 20 20 21 27 27 27 23 26 26 25 21 20 20 20 20 20 20 21 22 22 22 22 22 22 22 22 22 22 22 22 22 22 22 22 22 22 22 0 
0 31 22 22 22 22 22 21 23 23 23 21 22 22 22 22 22 22 22 22 22 22 22 22 22 21 23 23 23 23 23 23 23 23 23 23 23 23 21 20 20 20 20 20 21 21 21 21 21 21 21 21 21 20 20 20 20 20 20 21 22 22 22 22 22 22 22 22 22 22 22 22 22 22 22 22 22 22 22 0 
0 21 21 21 21 21 21 21 23 23 23 21 21 21 21 21 21 21 21 21 21 21 21 21 21 21 21 21 21 21 21 21 21 21 21 21 21 21 21 20 20 20 20 20 20 20 20 20 20 20 20 20 20 20 20 20 20 20 20 21 22 22 22 22 22 22 22 27 27 27 27 22 22 22 22 22 22 22 22 0 
0 23 23 23 23 25 25 21 20 20 20 20 20 20 20 20 20 20 20 20 20 20 20 20 20 20 20 20 20 20 20 20 20 20 20 20 20 20 20 20 20 20 20 20 20 20 20 20 20 20 20 20 20 20 20 20 20 20 20 21 21 21 21 21 21 21 21 21 21 21 21 21 21 21 21 21 21 21 21 0 
0 23 23 23 23 26 26 21 20 20 20 20 20 20 20 20 20 20 20 20 20 20 20 20 20 20 20 20 20 20 20 20 20 20 20 20 20 20 20 20 20 20 20 20 20 20 20 20 20 20 20 20 20 20 20 20 20 20 20 20 20 20 20 20 20 20 20 20 20 20 20 20 20 20 20 20 20 20 20 0 
0 23 23 23 23 26 26 21 20 20 20 20 20 20 20 20 20 20 20 20 20 20 20 20 20 20 20 20 20 20 20 20 20 20 20 20 20 20 20 20 20 20 20 20 20 20 20 20 20 20 20 20 20 20 20 20 20 20 20 20 20 20 20 20 20 20 20 20 20 20 20 20 20 20 20 20 20 20 20 0 
0 23 23 23 23 23 23 23 20 20 20 20 20 20 20 20 20 20 20 20 20 20 20 20 20 20 20 20 20 20 20 20 20 20 20 20 20 20 20 20 20 20 20 20 20 20 20 20 20 20 20 20 20 20 20 20 20 20 20 20 20 20 20 20 20 20 20 20 20 20 20 20 20 20 20 20 20 20 20 0 
0 23 23 23 23 23 23 23 20 20 20 20 20 20 20 20 20 20 20 20 20 20 20 20 20 20 20 20 20 20 20 20 20 20 20 20 20 20 20 20 20 20 20 20 20 20 20 20 20 20 20 20 20 20 20 20 20 20 20 20 20 20 20 20 20 20 20 20 20 20 20 20 20 20 20 20 20 20 20 0 
0 23 23 23 23 23 23 23 20 20 20 20 20 20 20 20 20 20 20 20 20 20 20 20 20 20 20 20 20 20 20 20 20 20 20 20 20 20 20 20 20 20 20 20 20 20 20 20 20 20 20 20 20 20 20 20 20 20 20 20 20 20 20 20 20 20 20 20 20 20 20 20 20 20 20 20 20 20 20 0 
0 23 23 23 23 23 23 23 20 20 20 20 20 20 20 20 20 20 20 20 20 20 20 20 20 20 20 20 20 20 20 20 20 20 20 20 20 20 20 20 20 20 20 20 20 20 20 20 20 20 20 20 20 20 20 20 20 20 20 20 20 20 20 20 20 20 20 20 20 20 20 20 20 20 20 20 20 20 20 0 
0 23 33 33 33 33 23 21 20 20 20 20 20 20 20 20 20 20 20 20 20 20 20 20 20 20 20 20 20 20 20 20 20 20 20 20 20 20 20 20 20 20 20 20 20 20 20 20 20 20 20 20 20 20 20 20 20 20 20 20 20 20 20 20 20 20 20 20 20 20 20 20 20 20 20 20 20 20 20 0 
0 34 33 33 33 33 34 21 20 20 20 20 20 20 20 20 20 20 20 20 20 20 20 20 20 20 20 20 20 20 20 20 20 20 20 20 20 20 20 20 20 20 20 20 20 20 20 20 21 21 21 21 21 21 21 21 21 21 21 21 21 21 21 21 21 21 21 21 21 23 23 23 21 21 21 21 21 21 21 0 
0 21 21 21 21 21 21 21 20 20 20 20 20 20 20 20 20 20 20 20 20 20 20 20 20 20 20 20 20 20 20 20 20 20 20 20 20 20 20 20 20 20 20 20 20 20 20 20 21 22 22 22 22 34 33 33 33 33 34 22 22 21 25 25 22 22 22 22 21 23 23 23 21 30 31 32 28 29 32 0 
0 20 20 20 20 20 20 20 20 20 20 20 20 20 20 20 20 20 20 20 20 20 20 20 20 20 20 20 20 20 20 20 20 20 20 20 20 20 20 20 20 20 20 20 20 20 20 20 21 22 22 22 22 22 33 33 33 33 22 22 22 21 26 26 22 22 22 22 21 23 23 23 21 32 32 32 32 32 32 0 
0 20 20 20 20 20 20 20 20 20 20 20 20 20 20 20 20 20 20 20 20 20 20 20 20 20 20 20 20 20 20 20 20 20 20 20 20 20 20 20 20 20 20 20 20 20 20 20 21 22 22 22 22 22 22 22 22 22 22 22 22 21 26 26 22 22 22 22 21 23 23 23 21 32 32 32 32 32 32 0 
0 20 20 20 20 20 20 20 20 20 20 20 20 20 20 20 20 20 20 20 20 20 20 20 20 20 20 20 20 20 20 20 20 20 20 20 20 20 20 20 20 20 20 20 20 20 20 20 21 22 22 22 22 22 22 22 22 22 22 22 22 21 22 22 22 22 22 22 21 23 23 23 21 32 32 32 32 32 32 0 
0 20 20 20 20 20 20 20 20 20 20 20 20 20 20 20 20 20 21 21 21 21 21 21 21 21 21 21 21 21 21 21 21 21 21 21 21 21 21 21 20 20 20 20 20 20 20 20 21 25 26 26 22 22 22 22 22 22 22 22 22 21 22 22 22 22 22 22 21 23 23 23 21 32 32 32 32 32 32 0 
0 20 20 20 20 20 20 20 20 20 20 20 20 20 20 20 20 20 21 23 23 23 23 23 23 23 23 23 23 23 23 23 23 23 23 34 23 34 23 21 20 20 20 20 20 20 20 20 21 25 26 26 22 22 22 22 22 22 27 27 27 21 27 27 22 22 22 22 21 23 23 23 21 32 32 32 32 32 32 0 
0 20 20 20 20 20 20 20 20 20 20 20 20 20 20 20 20 20 21 23 23 23 23 23 23 23 23 23 23 23 23 23 23 23 23 33 33 33 23 21 20 20 20 20 20 20 20 20 21 21 21 21 21 21 21 22 22 22 21 21 21 21 21 21 22 22 21 21 21 23 23 23 21 21 21 21 23 23 21 0 
0 20 20 20 20 21 21 21 21 21 21 21 21 21 21 20 20 20 21 23 23 23 23 23 23 23 23 23 23 23 23 23 23 23 23 33 33 33 23 21 20 20 20 20 20 20 20 20 21 25 25 22 22 34 21 23 23 23 23 23 23 23 23 23 23 23 23 23 21 23 23 23 21 23 23 23 23 23 23 0 
0 20 20 20 20 21 25 25 24 24 24 24 25 25 21 20 20 20 21 23 23 23 23 23 21 21 21 21 21 21 21 21 21 23 23 34 23 34 23 21 20 20 20 20 20 20 20 20 21 26 26 22 22 22 21 23 23 23 23 23 23 23 23 23 23 23 23 23 21 23 23 23 21 23 23 23 23 23 23 0 
0 20 20 20 20 21 26 26 22 22 22 22 26 26 21 20 20 20 21 23 23 23 23 23 21 25 25 24 24 24 22 22 21 23 23 23 23 23 23 21 20 20 20 20 20 20 20 20 21 26 26 22 22 22 21 23 23 23 23 23 34 23 34 23 23 23 23 23 21 23 23 23 21 23 23 23 23 23 23 0 
0 20 20 20 20 21 26 26 22 22 22 22 26 26 21 20 20 20 21 23 23 23 23 23 21 26 26 22 22 22 22 22 21 23 23 23 23 23 23 21 20 20 20 20 20 20 20 20 21 22 22 22 22 22 21 23 23 23 23 33 33 33 33 33 23 23 23 23 23 23 23 23 21 21 21 21 21 21 23 0 
0 20 20 20 20 22 22 22 22 22 22 22 22 22 21 20 20 20 21 21 20 20 21 21 21 26 26 22 22 22 22 22 21 23 23 23 23 23 23 21 20 20 20 20 20 20 20 20 21 22 22 22 22 22 21 23 23 23 23 33 33 33 33 33 23 23 23 23 23 23 23 23 23 23 23 23 23 23 23 0 
0 20 20 20 20 22 22 22 22 22 22 22 22 22 21 20 20 20 20 20 20 20 20 20 21 22 22 22 22 22 22 22 22 23 23 23 23 23 23 21 20 20 20 20 20 20 20 20 21 22 22 22 22 22 22 23 23 23 23 33 33 33 33 33 23 23 23 23 21 23 23 23 23 23 23 23 23 23 23 0 
0 20 3 3 20 21 22 22 33 33 33 33 22 22 21 20 20 20 20 20 20 20 20 20 21 22 22 22 22 22 22 22 22 23 23 23 23 23 23 21 20 20 3 3 3 3 20 20 21 22 22 22 22 22 22 23 23 23 23 23 34 23 34 23 23 23 23 23 21 23 23 23 23 23 21 23 23 23 23 0 
0 20 3 3 20 21 22 34 33 33 33 33 34 22 21 20 20 20 20 20 20 20 20 20 21 22 22 27 27 27 22 22 21 23 23 23 23 23 23 21 20 20 3 3 3 3 20 20 21 22 27 27 27 22 21 23 23 23 23 23 23 23 23 23 23 23 23 23 21 23 23 23 23 23 21 23 23 23 23 0 
0 0 0 0 0 0 0 0 0 0 0 0 0 0 0 0 0 0 0 0 0 0 0 0 0 0 0 0 0 0 0 0 0 0 0 0 0 0 0 0 0 0 0 0 0 0 0 0 0 0 0 0 0 0 0 0 0 0 0 0 0 0 0 0 0 0 0 0 0 0 0 0 0 0 0 0 0 0 0 0 
