0 0 0 0 00000000000000000000000000000000000000000000000000000000
011111111111111111111211111111111111121111111111111111111110
011111111111111111111211111111111111121111111111111111111110
011111111111111111111111111111111111121111111111111111111110
011111111111111111111111111111111111121111111111111111111110
011111111111111111111111111111111111121111111111111111111110
011111111111111111111211111111111111121111111111111111111110
011111111111111111111211111111111111121111111111111111111110
022222222222222211111222222333332222221111222222222222222220
011111111111111111111211111111111111121111111111121111111110
011111111111111111111211111111111111121111111111121111111110
011111111111111111111211111111111111121111111111121111111110
011111111111111111111211111111111111121111111111121111111110
011111111111111111111211111111111111121111111111121111111110
011111111111111111111211111111111111121111111111121111111110
011111111111111111111211111111111111121111111111121111111110
022222223333222222222211111111111111122222111112222222111110
011111111111111111111211111111111111121111111111121111111110
011111111111111111111211111111111111121111111111121111111110
011111111111111111111211111111111111121111111111121111111110
011111111111111111111211111111111111121111111111121111111110
011111111111111111111111111111111111111111111111121111111110
011111111111111111111111111111111111111111111111121111111110
011111111111111111111111111111111111111111111111121111111110
011111111111111111111111111111111111111111111111121111111110
011111111111111111111211111111111111121111111111111111111110
011111111111111111111211111111111111121111111111111111111110
011111111111111111111211111111111111121111111111111111111110
011111111111111111111211111111111111121111111111111111111110
000000000000000000000000000000000000000000000000000000000000