0 0 0 0 0 0 0 0 0 0 0 0 0 0 0 0 0 0 0 0 0 0 0 0 0 0 0 0 0 0 0 0 0 0 0 0 0 0 0 0 0 0 0 0 0 0 0 0 0 0 0 0 0 0 0 0 0 0 0 0 0 0 0 0 0 0 0 0 0 0 0 0 0 0 0 0 0 0 0 0 
0 1 1 1 1 1 1 1 1 1 1 1 1 1 1 1 1 1 1 1 1 1 1 1 1 1 1 1 1 1 1 1 1 1 1 1 1 3 3 3 3 3 3 3 1 1 1 1 1 1 1 1 1 1 1 1 1 1 1 1 1 1 1 1 1 1 1 1 1 1 1 1 1 1 1 1 1 1 1 0 
0 1 1 1 1 1 1 1 1 1 1 1 1 1 1 1 1 1 1 1 1 1 1 1 1 1 1 1 1 1 1 1 1 1 1 1 1 3 3 3 3 3 3 3 1 1 1 1 1 1 1 1 1 1 1 1 1 1 1 1 1 1 1 1 1 1 1 1 1 1 1 1 1 1 1 1 1 1 1 0 
0 1 1 1 1 1 1 1 1 1 1 1 1 1 1 1 1 1 1 1 1 1 1 1 1 1 1 1 1 1 1 1 1 1 1 1 1 1 1 1 1 1 1 1 1 1 1 1 1 1 1 1 1 1 1 1 1 1 1 1 1 1 1 1 1 1 1 1 1 1 1 1 1 1 1 1 1 1 1 0 
0 1 1 1 1 1 1 1 1 1 1 1 1 1 1 1 1 1 1 1 1 1 1 1 1 1 1 1 1 1 1 1 1 1 1 1 1 1 1 1 1 1 1 1 1 1 1 1 1 1 1 1 1 1 1 1 1 1 1 1 1 1 1 1 1 1 1 1 1 1 1 1 1 1 1 1 1 1 1 0 
0 1 1 1 1 1 2 2 2 2 2 2 2 2 2 2 2 2 2 2 2 2 2 2 2 2 2 2 2 2 2 2 14 1 1 1 1 1 1 1 1 1 1 1 1 1 1 1 14 2 2 2 2 2 2 2 2 2 2 2 2 2 2 2 2 2 2 2 2 2 2 2 2 2 1 1 1 1 1 0 
0 1 1 1 1 1 2 19 19 17 19 19 18 2 13 8 9 9 9 9 8 13 13 13 13 13 13 13 13 13 13 2 14 1 1 1 1 1 1 1 1 1 1 1 1 1 1 1 14 2 4 4 4 4 4 4 4 4 4 4 4 4 4 4 4 13 13 13 13 13 13 13 13 2 1 1 1 1 1 0 
0 1 1 1 1 1 2 19 19 19 19 19 19 2 13 13 9 9 9 9 13 13 13 13 13 13 13 13 13 13 13 2 14 1 1 1 1 1 1 1 1 1 1 1 1 1 1 1 14 2 4 4 4 4 4 4 4 4 4 4 4 4 4 4 4 13 13 13 13 13 13 13 13 2 1 1 1 1 1 0 
0 1 1 1 1 1 2 19 19 19 19 19 19 13 13 13 13 13 13 13 13 13 13 13 13 13 13 13 13 13 13 1 1 1 1 1 1 1 1 1 1 1 1 1 1 1 1 1 1 1 4 4 4 4 4 4 4 4 4 4 4 4 4 4 2 13 13 13 13 13 13 13 13 2 1 1 1 1 1 0 
0 1 1 1 1 1 2 19 19 19 19 19 19 13 13 13 13 13 13 13 13 13 13 13 13 13 13 13 13 13 13 1 1 1 1 1 1 1 1 1 1 1 1 1 1 1 1 1 1 1 4 4 4 4 4 4 4 4 4 4 4 4 4 4 2 7 7 13 13 13 13 7 7 2 1 1 1 1 1 0 
0 1 1 1 1 1 2 19 19 19 19 19 19 2 13 13 13 13 13 13 13 13 13 13 13 13 13 13 13 13 13 2 1 1 1 1 1 1 1 1 1 1 1 1 1 1 1 1 1 2 4 4 9 9 9 9 4 4 4 4 4 4 4 4 2 7 7 13 13 13 13 7 7 2 1 1 1 1 1 0 
0 1 1 1 1 1 2 19 19 19 19 15 19 2 13 13 13 13 13 13 13 13 2 2 2 2 2 2 2 2 2 2 1 1 1 1 1 1 1 1 1 1 1 1 1 1 1 1 1 2 4 8 9 9 9 9 8 4 4 4 4 4 4 4 2 6 6 12 12 12 12 6 6 2 1 1 1 1 1 0 
0 1 1 1 1 1 2 2 2 2 2 2 2 2 13 13 13 13 13 13 13 13 2 2 2 2 2 2 2 2 2 2 1 1 1 1 1 1 1 1 1 1 1 1 1 1 1 1 1 2 2 2 2 2 2 2 2 2 4 4 4 4 4 4 2 2 2 2 2 2 2 2 2 2 1 1 1 1 1 0 
0 1 1 1 1 1 2 4 8 9 9 8 4 2 13 13 13 13 13 13 13 13 2 2 2 2 2 2 2 2 2 2 1 1 1 1 1 1 1 1 1 1 1 1 1 1 1 1 1 2 2 2 2 2 2 2 2 2 4 4 4 4 4 4 2 2 2 2 2 2 2 2 2 2 1 1 1 1 1 0 
0 1 1 1 1 1 2 4 4 4 4 4 4 2 13 13 13 13 13 13 13 13 13 13 13 13 13 13 13 13 13 2 1 1 1 1 1 1 1 1 1 1 1 1 1 1 1 1 1 2 4 8 9 9 9 9 8 4 4 4 4 4 4 4 2 6 6 10 10 10 10 6 6 2 1 1 1 1 1 0 
0 1 1 1 1 1 2 4 4 4 4 4 4 13 13 13 13 13 13 13 13 13 13 13 13 13 13 13 13 13 13 1 1 1 1 1 1 1 1 1 1 1 1 1 1 1 1 1 1 2 4 4 9 9 9 9 4 4 4 4 4 4 4 4 2 7 7 11 11 11 11 7 7 2 1 1 1 1 1 0 
0 1 1 1 1 1 2 4 4 4 4 4 4 13 13 13 13 13 13 13 13 13 13 13 13 13 13 13 13 13 13 1 1 1 1 1 1 1 1 1 1 1 1 1 1 1 1 1 1 1 4 4 4 4 4 4 4 4 4 4 4 4 4 4 2 7 7 11 11 11 11 7 7 2 1 1 1 1 1 0 
0 1 1 1 1 1 2 4 4 4 4 4 4 2 13 13 9 9 9 9 13 13 13 13 13 13 13 13 13 13 13 2 14 1 1 1 1 1 1 1 1 1 1 1 1 1 1 1 1 1 4 4 4 4 4 4 4 4 4 4 4 4 4 4 2 11 11 11 11 11 11 11 11 2 1 1 1 1 1 0 
0 1 1 1 1 1 2 4 4 4 7 7 6 2 13 8 9 9 9 9 8 13 13 13 13 13 13 13 13 13 13 2 14 1 1 1 1 1 1 1 1 1 1 1 1 1 1 1 14 2 4 4 4 4 4 4 4 4 4 4 4 4 4 4 4 11 11 11 11 11 11 11 11 2 1 1 1 1 1 0 
0 1 1 1 1 1 2 2 2 2 2 2 2 2 2 2 2 2 2 2 2 2 2 2 2 2 2 2 2 2 2 2 14 1 1 1 1 1 1 1 1 1 1 1 1 1 1 1 14 2 4 4 4 4 4 4 4 4 4 4 4 4 4 4 4 11 11 11 11 11 11 11 11 2 1 1 1 1 1 0 
0 1 1 1 1 1 1 1 1 1 1 1 1 1 1 1 1 1 1 1 1 1 1 1 1 1 1 1 1 1 1 1 1 1 1 1 1 1 1 1 1 1 1 1 1 1 1 1 14 2 2 2 2 2 2 2 2 2 2 2 2 2 2 2 2 2 2 2 2 2 2 2 2 2 1 1 1 1 1 0 
0 1 1 1 1 1 1 1 1 1 1 1 1 1 1 1 1 1 1 1 1 1 1 1 1 1 1 1 1 1 1 1 1 1 1 1 1 1 1 1 1 1 1 1 1 1 1 1 1 1 1 1 1 1 1 1 1 1 1 1 1 1 1 1 1 1 1 1 1 1 1 1 1 1 1 1 1 1 1 0 
0 1 1 1 1 1 2 2 2 2 2 2 2 2 2 2 2 2 2 2 2 2 2 2 2 2 2 2 2 2 2 2 14 1 1 1 1 1 1 1 1 1 1 1 1 1 1 1 1 1 1 1 1 1 1 1 1 1 1 1 1 1 1 1 1 1 1 1 1 1 1 1 1 1 1 1 1 1 1 0 
0 1 1 1 1 1 2 4 4 4 7 7 6 2 11 8 9 9 9 9 8 11 11 11 11 11 11 11 11 11 11 2 14 1 1 1 1 1 1 1 1 1 1 1 1 1 1 1 14 2 2 2 2 2 2 2 2 2 2 2 2 2 2 2 2 2 2 2 2 2 2 2 2 2 1 1 1 1 1 0 
0 1 1 1 1 1 2 4 4 4 4 4 4 2 11 11 9 9 9 9 11 11 11 11 11 11 11 11 11 11 11 2 14 1 1 1 1 1 1 1 1 1 1 1 1 1 1 1 14 2 4 4 4 4 4 4 4 4 4 4 4 4 4 4 4 2 10 10 10 10 11 6 6 2 1 1 1 1 1 0 
0 1 1 1 1 1 2 4 4 4 4 4 4 4 11 11 11 11 11 11 11 11 11 11 11 11 11 11 11 11 11 1 1 1 1 1 1 1 1 1 1 1 1 1 1 1 1 1 14 2 4 4 4 4 4 4 4 4 4 4 4 4 4 4 4 11 11 11 11 11 11 7 7 2 1 1 1 1 1 0 
0 1 1 1 1 1 2 4 4 4 4 4 4 4 11 11 11 11 11 11 11 11 11 11 11 11 11 11 11 11 11 1 1 1 1 1 1 1 1 1 1 1 1 1 1 1 1 1 1 1 4 4 4 4 4 4 4 4 4 4 4 4 4 4 4 11 11 11 11 11 11 7 7 2 1 1 1 1 1 0 
0 1 1 1 1 1 2 4 4 4 4 4 4 2 11 11 11 11 11 11 11 11 2 2 2 2 2 2 2 2 2 2 1 1 1 1 1 1 1 1 1 1 1 1 1 1 1 1 1 1 4 4 4 4 4 4 4 4 4 4 4 4 4 4 8 2 8 11 11 11 11 11 11 2 1 1 1 1 1 0 
0 1 1 1 1 1 2 2 2 2 2 2 2 2 11 11 11 11 11 11 11 11 2 2 2 2 2 2 2 2 2 2 1 1 1 1 1 1 1 1 1 1 1 1 1 1 1 1 1 2 2 2 2 2 2 2 2 2 4 4 4 4 4 9 9 2 2 2 2 2 2 2 2 2 1 1 1 1 1 0 
0 1 1 1 1 1 2 19 18 17 19 19 19 2 11 11 11 11 11 11 11 11 2 2 2 2 2 2 2 2 2 2 1 1 1 1 1 1 1 1 1 1 1 1 1 1 1 1 1 2 2 2 2 2 2 2 2 2 4 4 4 4 4 9 9 2 2 2 2 2 2 2 2 2 1 1 1 1 1 0 
0 1 1 1 1 1 2 19 19 19 19 19 19 11 11 11 11 11 11 11 11 11 11 11 11 11 11 11 11 11 11 1 1 1 1 1 1 1 1 1 1 1 1 1 1 1 1 1 1 1 4 4 4 4 4 4 4 4 4 4 4 4 4 4 8 2 8 13 13 13 13 13 13 2 1 1 1 1 1 0 
0 1 1 1 1 1 2 19 19 19 19 19 19 11 11 11 11 11 11 11 11 11 11 11 11 11 11 11 11 11 11 1 1 1 1 1 1 1 1 1 1 1 1 1 1 1 1 1 1 1 4 4 4 4 4 4 4 4 4 4 4 4 4 4 4 13 13 13 13 13 13 7 7 2 1 1 1 1 1 0 
0 1 1 1 1 1 2 19 19 19 19 19 19 2 11 11 9 9 9 9 11 11 11 11 11 11 11 11 11 11 11 2 14 1 1 1 1 1 1 1 1 1 1 1 1 1 1 1 14 2 4 4 4 4 4 4 4 4 4 4 4 4 4 4 4 13 13 13 13 13 13 7 7 2 1 1 1 1 1 0 
0 1 1 1 1 1 2 19 15 16 19 19 19 2 11 8 9 9 9 9 8 11 11 11 11 11 11 11 11 11 11 2 14 1 1 1 1 1 1 1 1 1 1 1 1 1 1 1 14 2 4 4 4 4 4 4 4 4 4 4 4 4 4 4 4 2 12 12 12 12 13 6 6 2 1 1 1 1 1 0 
0 1 1 1 1 1 2 2 2 2 2 2 2 2 2 2 2 2 2 2 2 2 2 2 2 2 2 2 2 2 2 2 14 1 1 1 1 1 1 1 1 1 1 1 1 1 1 1 14 2 2 2 2 2 2 2 2 2 2 2 2 2 2 2 2 2 2 2 2 2 2 2 2 2 1 1 1 1 1 0 
0 1 1 1 1 1 1 1 1 1 1 1 1 1 1 1 1 1 1 1 1 1 1 1 1 1 1 1 1 1 1 1 1 1 1 1 1 1 1 1 1 1 1 1 1 1 1 1 1 1 1 1 1 1 1 1 1 1 1 1 1 1 1 1 1 1 1 1 1 1 1 1 1 1 1 1 1 1 1 0 
0 1 1 1 1 1 1 1 1 1 1 1 1 1 1 1 1 1 1 1 1 1 1 1 1 1 1 1 1 1 1 1 1 1 1 1 1 1 1 1 1 1 1 1 1 1 1 1 1 1 1 1 1 1 1 1 1 1 1 1 1 1 1 1 1 1 1 1 1 1 1 1 1 1 1 1 1 1 1 0 
0 1 1 1 1 1 1 1 1 1 1 1 1 1 1 1 1 1 1 1 1 1 1 1 1 1 1 1 1 1 1 1 1 1 1 1 1 3 3 3 3 3 3 3 1 1 1 1 1 1 1 1 1 1 1 1 1 1 1 1 1 1 1 1 1 1 1 1 1 1 1 1 1 1 1 1 1 1 1 0 
0 1 1 1 1 1 1 1 1 1 1 1 1 1 1 1 1 1 1 1 1 1 1 1 1 1 1 1 1 1 1 1 1 1 1 1 1 3 3 3 3 3 3 3 1 1 1 1 1 1 1 1 1 1 1 1 1 1 1 1 1 1 1 1 1 1 1 1 1 1 1 1 1 1 1 1 1 1 1 0 
0 0 0 0 0 0 0 0 0 0 0 0 0 0 0 0 0 0 0 0 0 0 0 0 0 0 0 0 0 0 0 0 0 0 0 0 0 0 0 0 0 0 0 0 0 0 0 0 0 0 0 0 0 0 0 0 0 0 0 0 0 0 0 0 0 0 0 0 0 0 0 0 0 0 0 0 0 0 0 0 
