0 0 0 0 0 0 0 0 0 0 0 0 0 0 0 0 0 0 0 0 0 0 0 0 0 0 0 0 0 0 0 0 0 0 0 0 0 0 0 0 0 0 0 0 0 0 0 0 0 0 0 0 0 0 0 0 0 0 0 0 0 0 0 0 0 0 0 0 0 0 0 0 0 0 0 0 0 0 0 0 
0 1 1 1 1 1 1 1 1 1 1 1 1 1 1 1 1 1 1 1 1 1 1 1 1 1 1 1 1 1 1 1 1 1 1 1 1 1 1 1 1 1 1 1 1 1 1 1 1 1 1 1 1 1 1 1 1 1 1 1 1 1 1 1 1 1 1 1 1 1 1 1 1 1 1 1 1 1 1 0 
0 1 1 1 1 1 1 1 1 1 1 1 1 1 1 1 1 1 1 1 1 1 1 1 1 1 1 1 1 1 1 1 1 1 1 1 1 1 1 1 1 1 1 1 1 1 1 1 1 1 1 1 1 1 1 1 1 1 1 1 1 1 1 1 1 1 1 1 1 1 1 1 1 1 1 1 1 1 1 0 
0 1 1 1 1 1 1 1 1 1 1 1 1 1 1 1 1 1 1 1 1 1 1 1 1 1 1 1 1 1 1 1 1 1 1 1 1 1 1 1 1 1 1 1 1 1 1 1 1 1 1 1 1 1 1 1 1 1 1 1 1 1 1 1 1 1 1 1 1 1 1 1 1 1 1 1 1 1 1 0 
0 1 1 1 1 1 2 2 2 2 2 2 2 2 1 1 1 1 1 2 2 2 2 2 2 2 2 2 2 2 2 2 2 2 2 2 2 2 1 1 1 1 2 2 2 2 2 2 2 2 2 2 2 2 2 2 2 2 2 2 2 1 1 1 1 1 2 2 2 1 1 2 2 2 1 1 1 1 1 0 
0 1 1 1 1 1 2 6 7 7 4 4 8 2 1 1 1 1 1 2 4 4 4 4 6 6 4 4 4 6 6 4 4 4 6 6 4 2 1 1 1 1 2 4 6 6 4 4 4 6 6 4 4 4 6 6 4 4 4 4 2 1 1 1 1 1 2 8 8 4 4 4 4 2 1 1 1 1 1 0 
0 1 1 1 1 1 2 6 7 7 4 4 4 2 14 1 1 1 14 2 4 4 4 4 7 7 4 4 4 7 7 4 4 4 7 7 4 2 1 1 1 1 2 4 7 7 4 4 4 7 7 4 4 4 7 7 4 4 4 4 2 14 1 1 1 1 2 4 4 4 4 4 4 2 1 1 1 1 1 0 
0 1 1 1 1 1 2 4 4 4 4 4 4 1 1 1 1 1 1 1 4 4 4 4 7 7 4 4 4 7 7 4 4 4 7 7 4 2 1 1 1 1 2 4 7 7 4 4 4 7 7 4 4 4 7 7 4 4 4 4 1 1 1 1 1 1 2 4 4 4 4 4 4 2 1 1 1 1 1 0 
0 1 1 1 1 1 2 4 4 4 4 4 4 1 1 1 1 1 1 1 4 4 4 4 4 4 4 4 4 4 4 4 4 4 4 4 4 2 1 1 1 1 2 4 4 4 4 4 4 4 4 4 4 4 4 4 4 4 4 4 1 1 1 1 1 1 2 4 4 4 4 4 4 2 1 1 1 1 1 0 
0 1 1 1 1 1 2 4 4 4 4 4 4 2 14 1 1 1 14 2 4 4 4 4 4 4 4 4 4 4 4 4 4 4 4 4 4 2 1 1 1 1 2 4 4 4 4 4 4 4 4 4 4 4 4 4 4 4 4 4 2 14 1 1 1 1 2 6 7 7 4 4 4 2 1 1 1 1 1 0 
0 1 1 1 1 1 2 4 4 4 4 4 8 2 1 1 1 1 1 2 4 4 4 4 4 4 4 4 4 4 4 4 4 4 4 4 4 2 1 1 1 1 2 4 4 4 4 4 4 4 4 4 4 4 4 4 4 4 4 4 2 1 1 1 1 1 2 6 7 7 12 12 12 2 1 1 1 1 1 0 
0 1 1 1 1 1 2 2 2 2 2 2 2 2 1 1 1 1 1 2 2 2 2 2 2 2 2 2 2 2 2 2 2 2 2 2 2 2 1 1 1 1 2 2 2 2 2 2 2 2 2 2 2 2 2 2 2 2 2 2 2 1 1 1 1 1 2 2 2 2 2 2 2 2 1 1 1 1 1 0 
0 3 3 3 3 1 1 1 1 1 1 1 1 1 1 1 1 1 1 1 1 1 1 1 1 1 1 1 1 1 1 1 1 1 1 1 1 1 1 1 1 1 1 1 1 1 1 1 1 1 1 1 1 1 1 1 1 1 1 1 1 1 1 1 1 1 1 1 1 1 1 1 1 1 1 3 3 3 3 0 
0 3 3 3 3 1 1 1 1 1 1 1 1 1 1 1 1 1 1 1 1 1 1 1 1 1 1 1 1 1 1 1 1 1 1 1 1 1 1 1 1 1 1 1 1 1 1 1 1 1 1 1 1 1 1 1 1 1 1 1 1 1 1 1 1 1 1 1 1 1 1 1 1 1 1 3 3 3 3 0 
0 3 3 3 3 1 1 1 1 1 1 1 1 1 1 1 1 1 1 1 1 1 1 1 1 1 1 1 1 1 1 1 1 1 1 1 1 1 1 1 1 1 1 1 1 1 1 1 1 1 1 1 1 1 1 1 1 1 1 1 1 1 1 1 1 1 1 1 1 1 1 1 1 1 1 3 3 3 3 0 
0 3 3 3 3 1 1 1 1 1 1 1 1 1 1 1 1 1 1 1 1 1 1 1 1 1 1 1 1 1 1 1 1 1 1 1 1 1 1 1 1 1 1 1 1 1 1 1 1 1 1 1 1 1 1 1 1 1 1 1 1 1 1 1 1 1 1 1 1 1 1 1 1 1 1 3 3 3 3 0 
0 1 1 1 1 1 2 2 2 2 2 2 2 2 1 1 1 1 1 2 2 2 2 2 2 2 2 2 2 2 2 2 2 2 2 2 2 2 1 1 1 1 2 2 2 2 2 2 2 2 2 2 2 2 2 2 2 2 2 2 2 1 1 1 1 1 2 2 2 2 2 2 2 2 1 1 1 1 1 0 
0 1 1 1 1 1 2 6 6 4 4 4 8 2 1 1 1 1 1 2 4 4 4 4 4 4 4 4 4 4 4 4 4 4 4 4 4 2 1 1 1 1 2 4 4 4 4 4 4 4 4 4 4 4 4 4 4 4 4 4 2 1 1 1 1 1 2 10 10 10 4 4 8 2 1 1 1 1 1 0 
0 1 1 1 1 1 2 7 7 4 4 4 8 2 1 1 1 1 14 2 4 4 4 4 4 4 4 4 4 4 4 4 4 4 4 4 4 2 1 1 1 1 2 4 4 4 4 4 4 4 4 4 4 4 4 4 4 4 4 4 2 14 1 1 1 1 2 4 4 4 4 4 4 2 1 1 1 1 1 0 
0 1 1 1 1 1 2 7 7 4 4 4 4 2 1 1 1 1 1 1 4 4 4 4 4 4 4 4 4 4 4 4 4 4 4 4 4 2 1 1 1 1 2 4 4 4 4 4 4 4 4 4 4 4 4 4 4 4 4 4 1 1 1 1 1 1 2 4 4 4 4 4 4 1 1 1 1 1 1 0 
0 1 1 1 1 1 2 4 4 4 4 4 4 2 1 1 1 1 1 1 4 4 4 4 7 7 4 4 4 7 7 4 4 4 7 7 4 2 1 1 1 1 2 4 7 7 4 4 4 7 7 4 4 4 7 7 4 4 4 4 1 1 1 1 1 1 2 4 4 4 4 4 4 1 1 1 1 1 1 0 
0 1 1 1 1 1 2 4 4 4 4 4 4 2 1 1 1 1 14 2 4 4 4 4 7 7 4 4 4 7 7 4 4 4 7 7 4 2 1 1 1 1 2 4 7 7 4 4 4 7 7 4 4 4 7 7 4 4 4 4 2 14 1 1 1 1 2 6 7 7 4 4 8 2 1 1 1 1 1 0 
0 1 1 1 1 1 2 8 4 4 4 4 4 2 1 1 1 1 1 2 4 4 4 4 6 6 4 4 4 6 6 4 4 4 6 6 4 2 1 1 1 1 2 4 6 6 4 4 4 6 6 4 4 4 6 6 4 4 4 4 2 1 1 1 1 1 2 6 7 7 4 4 8 2 1 1 1 1 1 0 
0 1 1 1 1 1 2 2 2 1 1 2 2 2 1 1 1 1 1 2 2 2 2 2 2 2 2 2 2 2 2 2 2 2 2 2 2 2 1 1 1 1 2 2 2 2 2 2 2 2 2 2 2 2 2 2 2 2 2 2 2 1 1 1 1 1 2 2 2 2 2 2 2 2 1 1 1 1 1 0 
0 3 3 3 3 1 1 1 14 1 1 14 1 1 1 1 1 1 1 1 1 1 1 1 1 1 1 1 1 1 1 1 1 1 1 1 1 1 1 1 1 1 1 1 1 1 1 1 1 1 1 1 1 1 1 1 1 1 1 1 1 1 1 1 1 1 1 1 1 1 1 1 1 1 1 3 3 3 3 0 
0 3 3 3 3 1 1 1 1 1 1 1 1 1 1 1 1 1 1 1 1 1 1 1 1 1 1 1 1 1 1 1 1 1 1 1 1 1 1 1 1 1 1 1 1 1 1 1 1 1 1 1 1 1 1 1 1 1 1 1 1 1 1 1 1 1 1 1 1 1 1 1 1 1 1 3 3 3 3 0 
0 3 3 3 3 1 1 1 1 1 1 1 1 1 1 1 1 1 1 1 1 1 1 1 1 1 1 1 1 1 1 1 1 1 1 1 1 1 1 1 1 1 1 1 1 1 1 1 1 1 1 1 1 1 1 1 1 1 1 1 1 1 1 1 1 1 1 1 1 1 1 1 1 1 1 3 3 3 3 0 
0 3 3 3 3 1 1 1 1 1 1 1 1 1 1 1 1 1 1 1 1 1 1 1 1 1 1 1 1 1 1 1 1 1 1 1 1 1 1 1 1 1 1 1 1 1 1 1 1 1 1 1 1 1 1 1 1 1 1 1 1 1 1 1 1 1 1 1 1 1 1 1 1 1 1 3 3 3 3 0 
0 1 1 1 1 1 2 2 2 2 2 2 2 2 1 1 1 1 1 2 2 2 2 2 2 2 2 2 2 2 2 2 2 2 2 2 2 2 1 1 1 1 2 2 2 2 2 2 2 2 2 2 2 2 2 2 2 2 2 2 2 1 1 1 1 1 2 2 2 2 2 2 2 2 1 1 1 1 1 0 
0 1 1 1 1 1 2 8 4 4 7 7 6 2 1 1 1 1 1 2 4 4 4 4 6 6 4 4 4 6 6 4 4 4 6 6 4 2 1 1 1 1 2 4 6 6 4 4 4 6 6 4 4 4 6 6 4 4 4 4 2 1 1 1 1 1 2 14 4 4 4 6 6 2 1 1 1 1 1 0 
0 1 1 1 1 14 2 8 4 4 7 7 6 2 1 1 1 1 14 2 4 4 4 4 7 7 4 4 4 7 7 4 4 4 7 7 4 2 1 1 1 1 2 4 7 7 4 4 4 7 7 4 4 4 7 7 4 4 4 4 2 14 1 1 1 1 2 4 4 4 4 7 7 2 1 1 1 1 1 0 
0 1 1 1 1 1 1 4 4 4 4 4 4 2 1 1 1 1 1 1 4 4 4 4 7 7 4 4 4 7 7 4 4 4 7 7 4 2 1 1 1 1 2 4 7 7 4 4 4 7 7 4 4 4 7 7 4 4 4 4 1 1 1 1 1 1 2 4 4 4 4 7 7 2 1 1 1 1 1 0 
0 1 1 1 1 1 1 4 4 4 4 4 4 2 1 1 1 1 1 1 4 4 4 4 4 4 4 4 4 4 4 4 4 4 4 4 4 2 1 1 1 1 2 4 4 4 4 4 4 4 4 4 4 4 4 4 4 4 4 4 1 1 1 1 1 1 2 4 4 4 4 4 4 2 1 1 1 1 1 0 
0 1 1 1 1 14 2 4 4 4 4 4 4 2 1 1 1 1 14 2 4 4 4 4 4 4 4 4 4 4 4 4 4 4 4 4 4 2 1 1 1 1 2 4 4 4 4 4 4 4 4 4 4 4 4 4 4 4 4 4 2 14 1 1 1 1 2 4 4 4 4 4 4 2 1 1 1 1 1 0 
0 1 1 1 1 1 2 8 4 4 4 4 8 2 1 1 1 1 1 2 4 4 4 4 4 4 4 4 4 4 4 4 4 4 4 4 4 2 1 1 1 1 2 4 4 4 4 4 4 4 4 4 4 4 4 4 4 4 4 4 2 1 1 1 1 1 2 4 4 4 4 12 12 2 1 1 1 1 1 0 
0 1 1 1 1 1 2 2 2 2 2 2 2 2 1 1 1 1 1 2 2 2 2 2 2 2 2 2 2 2 2 2 2 2 2 2 2 2 1 1 1 1 2 2 2 2 2 2 2 2 2 2 2 2 2 2 2 2 2 2 2 1 1 1 1 1 2 2 2 1 1 2 2 2 1 1 1 1 1 0 
0 1 1 1 1 1 1 1 1 1 1 1 1 1 1 1 1 1 1 1 1 1 1 1 1 1 1 1 1 1 1 1 1 1 1 1 1 1 1 1 1 1 1 1 1 1 1 1 1 1 1 1 1 1 1 1 1 1 1 1 1 1 1 1 1 1 1 1 1 1 1 1 1 1 1 1 1 1 1 0 
0 1 1 1 1 1 1 1 1 1 1 1 1 1 1 1 1 1 1 1 1 1 1 1 1 1 1 1 1 1 1 1 1 1 1 1 1 1 1 1 1 1 1 1 1 1 1 1 1 1 1 1 1 1 1 1 1 1 1 1 1 1 1 1 1 1 1 1 1 1 1 1 1 1 1 1 1 1 1 0 
0 1 1 1 1 1 1 1 1 1 1 1 1 1 1 1 1 1 1 1 1 1 1 1 1 1 1 1 1 1 1 1 1 1 1 1 1 1 1 1 1 1 1 1 1 1 1 1 1 1 1 1 1 1 1 1 1 1 1 1 1 1 1 1 1 1 1 1 1 1 1 1 1 1 1 1 1 1 1 0 
0 0 0 0 0 0 0 0 0 0 0 0 0 0 0 0 0 0 0 0 0 0 0 0 0 0 0 0 0 0 0 0 0 0 0 0 0 0 0 0 0 0 0 0 0 0 0 0 0 0 0 0 0 0 0 0 0 0 0 0 0 0 0 0 0 0 0 0 0 0 0 0 0 0 0 0 0 0 0 0 
