0 0 0 0 0 0 0 0 0 0 0 0 0 0 0 0 0 0 0 0 0 0 0 0 0 0 0 0 0 0 0 0 0 0 0 0 0 0 0 0 0 0 0 0 0 0 0 0 0 0 0 0 0 0 0 0 0 0 0 0 0 0 0 0 0 0 0 0 0 0 0 0 0 0 0 0 0 0 0 0 
0 4 4 4 4 4 4 4 4 4 4 4 4 4 4 4 4 4 4 4 4 4 4 4 4 4 4 4 4 4 4 4 4 4 2 1 1 3 3 3 3 1 1 1 1 1 1 1 1 1 1 1 1 1 1 1 1 1 1 1 1 1 1 1 1 1 1 1 1 1 1 1 1 1 1 1 1 1 1 0 
0 4 4 4 4 4 4 4 4 4 4 4 4 4 4 4 4 4 4 4 4 4 4 4 4 4 4 4 4 4 4 4 4 4 2 1 1 3 3 3 3 1 1 1 1 1 1 1 1 1 1 1 1 1 1 1 1 1 1 1 1 1 1 1 1 1 1 1 1 1 1 1 1 1 1 1 3 3 3 0 
0 4 4 4 4 4 2 2 2 2 2 2 2 2 2 4 4 4 4 4 2 2 2 2 2 2 2 2 2 4 4 4 4 4 2 1 1 1 1 1 1 1 1 1 1 1 1 1 1 1 1 1 1 1 1 1 1 1 1 1 1 1 1 1 1 1 1 1 1 1 1 1 1 1 1 1 3 3 3 0 
0 4 4 4 4 4 2 6 6 8 9 9 8 5 2 14 4 4 4 14 2 5 8 9 9 8 6 6 2 4 4 4 4 4 2 1 1 1 1 1 1 1 1 1 1 1 1 1 1 1 1 1 1 1 1 1 1 1 1 1 1 1 1 1 1 1 1 1 1 1 1 1 1 1 1 1 3 3 3 0 
0 4 4 4 4 4 2 7 7 5 5 5 5 5 5 4 4 4 4 4 5 5 5 5 5 5 7 7 2 4 4 4 4 4 2 1 1 1 1 1 1 1 1 1 1 1 1 1 1 1 1 1 1 1 1 1 1 1 1 1 1 1 1 1 1 1 1 1 1 1 1 1 1 1 1 1 1 1 1 0 
0 4 4 4 4 4 2 7 7 5 5 5 5 5 5 4 4 4 4 4 5 5 5 5 5 5 7 7 2 4 4 4 4 4 2 1 1 1 1 1 1 1 1 1 1 1 1 1 1 1 1 1 1 1 1 1 1 1 1 1 1 1 1 1 1 1 1 1 1 2 2 2 2 2 2 2 2 2 2 0 
0 4 4 4 4 4 2 5 5 5 5 5 5 5 5 4 4 4 4 4 5 5 5 5 5 5 5 5 2 4 4 4 4 4 2 1 1 1 1 1 1 1 1 1 1 1 1 1 1 1 1 1 1 1 1 1 1 1 1 1 1 1 1 1 1 1 1 1 1 2 1 1 1 1 1 1 1 1 1 0 
0 4 4 4 4 4 2 5 5 5 5 5 5 5 2 14 4 4 4 14 2 5 5 5 5 5 5 5 2 4 4 4 4 4 2 1 1 1 1 1 1 1 1 1 1 1 1 1 1 1 1 1 1 1 1 1 1 1 1 1 1 1 1 1 1 1 1 1 1 1 1 1 1 1 1 1 1 1 1 0 
0 4 4 4 4 4 2 2 2 2 2 2 2 2 2 4 4 4 4 4 2 2 2 2 2 2 2 2 2 4 4 4 4 4 2 1 1 1 1 1 1 1 1 1 1 1 1 1 1 1 1 1 1 1 1 1 1 1 1 1 1 1 1 1 1 1 1 1 1 1 1 1 1 1 1 1 1 1 1 0 
0 4 4 4 4 4 4 4 4 4 4 4 4 4 4 4 4 4 4 4 4 4 4 4 4 4 4 4 4 4 4 4 4 4 2 1 1 1 1 1 1 1 1 1 1 1 1 1 1 1 1 1 1 1 1 1 1 1 1 1 1 1 1 1 1 1 1 1 1 2 1 1 1 1 1 1 1 1 1 0 
0 4 4 4 4 4 4 4 4 4 4 4 4 4 4 4 4 4 4 4 4 4 4 4 4 4 4 4 4 4 4 4 4 4 2 1 1 1 1 1 1 1 1 1 1 1 1 1 1 1 1 1 1 1 1 1 1 1 1 1 1 1 1 1 1 1 1 1 1 2 1 1 1 2 2 2 1 1 1 0 
0 2 1 1 1 2 2 2 2 2 2 2 2 2 2 2 2 2 2 2 2 2 2 2 2 2 2 2 2 2 2 2 2 2 2 1 1 1 1 1 1 1 1 1 1 1 1 1 1 1 1 1 1 1 1 1 1 1 1 1 1 1 1 1 1 1 1 1 1 2 1 1 1 2 2 2 1 1 1 0 
0 1 1 1 1 1 1 1 1 1 1 1 1 1 1 1 1 1 1 1 1 1 1 1 2 2 1 1 1 1 1 1 1 1 1 1 1 1 1 1 1 1 1 1 1 1 1 1 1 1 1 1 1 1 1 1 1 1 1 1 1 1 1 1 1 1 1 1 1 2 1 1 1 2 2 2 1 1 1 0 
0 1 1 1 1 1 1 1 1 1 1 1 1 1 1 1 1 1 1 1 1 1 1 1 2 2 1 1 1 1 1 1 1 1 1 1 1 1 1 1 1 1 1 1 1 1 1 1 1 1 1 1 1 1 1 1 1 1 1 1 1 1 1 1 1 1 1 1 1 2 1 1 1 2 2 2 1 1 1 0 
0 1 1 1 1 1 1 1 1 1 1 1 1 1 1 1 1 1 1 1 1 1 1 1 2 2 1 1 1 1 1 1 1 1 1 1 1 1 1 1 1 1 1 1 1 1 1 1 1 1 1 1 2 2 2 2 2 2 2 2 2 2 2 2 1 1 1 1 1 2 1 1 1 2 2 2 1 1 1 0 
0 1 1 1 1 1 1 1 1 1 1 1 1 1 1 1 1 1 1 1 1 1 1 1 2 2 1 1 1 1 1 1 1 1 1 1 1 1 1 1 1 1 1 1 1 1 1 1 1 1 1 1 2 5 10 10 10 5 5 5 5 6 6 2 1 1 1 1 1 2 1 1 1 2 2 2 1 1 1 0 
0 1 1 1 1 1 1 1 1 1 1 1 1 1 1 1 1 1 1 1 1 1 1 1 2 2 1 1 1 1 1 1 1 1 1 1 1 1 1 1 1 1 1 1 1 1 1 1 1 1 1 1 2 5 5 5 5 5 5 5 5 7 7 2 1 1 1 1 1 2 1 1 1 2 2 2 1 1 1 0 
0 1 1 1 1 1 1 1 1 1 1 1 1 1 1 1 1 1 1 1 1 1 1 1 1 1 1 1 1 1 1 1 1 1 1 1 1 1 1 1 1 1 1 1 1 1 1 1 1 1 1 1 2 5 5 5 5 5 5 5 5 7 7 2 1 1 1 1 1 2 1 1 1 2 2 2 1 1 1 0 
0 1 1 1 1 1 1 2 2 1 1 2 2 2 2 2 2 2 2 2 2 1 1 1 1 1 1 1 1 2 2 2 2 2 2 2 2 2 1 1 2 2 2 1 1 1 1 1 1 1 1 14 2 5 5 5 5 5 5 5 5 5 5 2 1 1 1 1 1 2 1 1 1 2 2 2 1 1 1 0 
0 1 1 1 1 1 1 2 14 5 5 14 5 5 2 15 16 19 17 18 2 1 1 1 1 1 1 1 1 2 19 19 19 17 18 2 5 14 5 5 14 5 2 1 1 1 1 1 1 1 1 1 1 5 5 5 5 5 5 5 5 5 5 2 1 1 1 1 1 2 1 1 1 2 2 2 1 1 1 0 
0 1 1 1 1 1 1 2 5 5 5 5 5 5 2 19 19 19 19 19 2 1 1 1 1 1 1 1 1 2 19 19 19 19 19 2 5 5 5 5 5 5 2 1 1 1 1 1 1 1 1 1 1 5 5 5 5 8 5 5 5 5 5 2 1 1 1 1 1 2 1 1 1 1 1 1 1 1 1 0 
0 1 1 1 1 1 1 2 5 5 5 5 5 5 2 19 19 19 19 19 2 1 1 1 1 1 1 1 1 2 19 19 19 19 19 2 5 5 5 5 5 5 2 1 1 1 1 1 1 1 1 14 2 5 5 5 9 9 9 5 5 5 5 2 1 1 1 1 1 1 1 1 1 1 1 1 1 1 1 0 
0 1 1 1 1 1 1 2 5 5 5 5 5 5 2 19 19 19 19 19 2 1 1 1 1 1 1 1 1 2 19 19 19 19 19 2 5 5 5 5 5 5 2 1 1 1 1 1 1 1 1 1 2 5 5 8 9 9 9 8 5 5 5 2 1 1 1 1 1 1 1 1 1 1 1 1 1 1 1 0 
0 1 1 1 1 1 1 2 5 5 5 5 5 5 2 19 19 19 19 19 2 1 1 1 1 1 1 1 1 2 19 19 19 15 16 2 5 5 5 5 5 5 2 1 1 1 1 1 1 1 1 1 2 5 5 5 9 9 9 5 5 5 5 2 1 1 1 1 1 2 1 1 1 1 1 1 1 1 1 0 
0 1 1 1 1 1 1 2 5 5 5 5 5 5 2 2 2 2 5 5 2 1 1 1 1 1 1 1 1 2 5 5 2 2 2 2 5 5 5 5 5 5 2 1 1 1 1 1 1 1 1 1 2 5 5 5 5 8 5 5 5 5 5 2 1 1 1 1 1 2 2 2 2 2 2 2 2 2 2 0 
0 1 1 1 1 1 1 2 5 5 5 5 5 5 2 6 6 5 5 5 2 1 1 1 1 1 1 1 1 2 5 5 5 6 6 2 5 5 5 5 5 5 2 1 1 1 1 1 1 1 1 1 2 2 2 2 2 2 2 2 2 2 2 2 1 1 1 1 1 1 1 1 1 1 1 1 1 1 1 0 
0 1 1 1 1 1 1 2 5 8 5 5 5 5 2 7 7 5 5 5 2 1 1 1 1 1 1 1 1 2 5 5 5 7 7 2 5 5 5 5 5 5 2 1 1 1 1 1 1 1 1 1 1 1 1 1 1 1 1 1 1 1 1 1 1 1 1 1 1 1 1 1 1 1 1 1 1 1 1 0 
0 1 1 1 1 1 1 2 9 9 9 5 5 5 2 7 7 5 5 5 2 1 1 1 1 1 1 1 1 2 5 5 5 7 7 2 5 5 5 5 8 5 2 1 1 1 1 1 1 1 1 1 1 1 1 1 1 1 1 1 1 1 1 1 1 1 1 1 1 1 1 1 1 1 1 1 1 1 1 0 
0 1 1 1 1 1 1 2 9 9 9 8 5 5 5 5 5 5 5 5 2 1 1 1 1 1 1 1 1 2 5 5 5 5 5 5 5 5 5 9 9 9 2 1 1 1 1 1 1 1 1 1 1 1 1 1 1 1 1 1 1 1 1 1 1 1 1 1 1 1 1 1 1 1 1 1 1 1 1 0 
0 1 1 1 1 1 1 2 9 9 9 5 5 5 5 5 5 5 5 5 2 1 1 1 1 1 1 1 1 2 5 5 5 5 5 5 5 5 8 9 9 9 2 1 1 1 1 1 1 1 1 1 1 1 1 1 1 1 1 2 2 2 2 2 2 2 2 2 2 2 1 1 1 1 1 1 1 1 1 0 
0 1 1 1 1 1 1 2 2 2 2 2 2 2 2 2 2 2 2 2 2 1 1 1 1 1 1 1 1 2 2 2 2 2 2 2 2 2 2 2 2 2 2 1 1 1 1 1 1 1 1 1 1 1 1 1 1 1 1 2 6 6 4 4 4 8 4 4 4 2 1 1 1 1 1 1 1 1 1 0 
0 1 1 1 1 1 1 1 1 1 1 1 1 1 1 1 1 1 1 1 1 1 1 1 1 1 1 1 1 1 1 1 1 1 1 1 1 1 1 1 1 1 1 1 1 1 1 1 1 1 1 1 1 1 1 1 1 1 1 2 7 7 4 4 9 9 9 4 4 2 1 1 1 1 1 1 1 1 1 0 
0 1 1 1 1 1 1 1 1 1 1 1 1 1 1 1 1 1 1 1 1 1 1 1 1 1 1 1 1 1 1 1 1 1 1 1 1 1 1 1 1 1 1 1 1 1 1 2 2 1 1 1 1 1 1 1 1 1 1 2 7 7 4 4 9 9 9 4 4 2 14 1 1 1 1 1 1 1 1 0 
0 1 1 1 1 1 1 1 1 1 1 1 1 1 1 1 1 1 1 1 1 1 1 1 2 2 1 1 1 1 1 1 1 1 1 1 1 1 1 1 1 1 1 1 1 1 1 2 2 1 1 1 1 1 1 1 1 1 1 2 4 4 4 4 4 8 4 4 4 1 1 1 1 1 1 1 1 1 1 0 
0 1 3 3 3 3 1 1 1 1 1 1 1 1 1 1 1 1 1 1 1 1 1 1 2 2 1 1 1 1 1 1 1 1 1 1 1 1 1 1 1 1 1 1 1 1 1 2 2 1 1 1 1 1 1 1 1 1 1 2 4 4 4 4 4 4 4 4 4 1 1 1 1 1 1 1 1 1 1 0 
0 1 3 3 3 3 1 1 1 1 1 1 1 1 1 1 1 1 1 1 1 1 1 1 2 2 1 1 1 1 1 1 1 1 1 1 1 1 1 1 1 1 1 1 1 1 1 2 2 1 1 1 1 1 1 1 1 1 1 2 4 4 4 4 4 4 4 4 4 2 14 1 1 3 3 3 3 1 1 0 
0 1 3 3 3 3 1 1 1 1 1 1 1 1 1 1 1 1 1 1 1 1 1 1 2 2 1 1 1 1 1 1 1 1 1 1 1 1 1 1 1 1 1 1 1 1 1 2 2 1 1 1 1 1 1 1 1 1 1 2 4 4 4 4 4 4 4 4 4 2 1 1 1 3 3 3 3 1 1 0 
0 1 3 3 3 3 1 1 1 1 1 1 1 1 1 1 1 1 1 1 1 1 1 1 2 2 1 1 1 1 1 1 1 1 1 1 1 1 1 1 1 1 1 1 1 1 1 2 2 1 1 1 1 1 1 1 1 1 1 2 4 12 12 12 4 4 4 4 4 2 1 1 1 3 3 3 3 1 1 0 
0 0 0 0 0 0 0 0 0 0 0 0 0 0 0 0 0 0 0 0 0 0 0 0 0 0 0 0 0 0 0 0 0 0 0 0 0 0 0 0 0 0 0 0 0 0 0 0 0 0 0 0 0 0 0 0 0 0 0 0 0 0 0 0 0 0 0 0 0 0 0 0 0 0 0 0 0 0 0 0 
