0 0 0 0 0 0 0 0 0 0 0 0 0 0 0 0 0 0 0 0 0 0 0 0 0 0 0 0 0 0 0 0 0 0 0 0 0 0 0 0 0 0 0 0 0 0 0 0 0 0 0 0 0 0 0 0 0 0 0 0 0 0 0 0 0 0 0 0 0 0 0 0 0 0 0 0 0 0 0 0 
0 18 5 5 5 10 10 2 3 3 3 2 4 4 4 4 4 2 5 5 10 10 10 5 5 2 6 6 5 5 5 5 2 15 16 19 17 18 2 1 1 1 1 1 2 4 4 4 4 4 4 4 2 1 1 1 1 1 1 2 4 4 4 4 4 4 4 4 4 4 4 4 2 5 5 5 5 5 5 0 
0 5 5 5 5 5 5 2 3 3 3 2 4 4 4 4 4 2 5 5 5 5 5 5 5 2 7 7 5 5 5 5 2 19 19 19 19 19 2 1 1 1 1 1 2 4 4 4 4 4 4 4 2 1 1 1 1 1 1 2 4 4 4 4 4 4 4 4 4 4 4 4 2 5 5 5 5 5 5 0 
0 5 5 5 5 5 5 2 4 4 4 2 4 4 4 4 4 2 5 5 5 5 5 5 5 2 7 7 5 5 5 5 2 19 19 19 19 19 2 1 1 1 1 1 2 4 4 4 4 4 4 4 2 1 1 1 1 1 1 2 4 4 4 4 4 4 4 4 4 4 4 4 2 5 5 5 5 5 5 0 
0 5 5 5 5 5 5 4 4 4 4 4 4 4 4 4 4 2 5 5 5 5 5 5 5 2 5 5 5 5 5 5 2 19 19 19 19 19 2 1 1 1 1 1 2 4 4 4 4 4 4 4 2 1 1 1 1 1 1 2 4 4 4 4 4 4 4 4 4 4 4 4 2 5 5 5 5 5 5 2 
0 5 5 5 5 5 5 4 4 4 4 4 4 4 4 4 4 2 5 5 5 5 5 5 5 2 12 12 5 5 5 5 2 19 19 19 19 19 2 1 1 1 1 1 2 4 4 4 4 4 4 4 2 1 1 1 1 1 1 2 2 2 2 2 2 2 2 2 2 2 4 4 2 5 5 5 5 5 5 0 
0 5 5 5 7 7 6 2 4 4 4 2 2 4 4 2 2 2 2 2 2 4 4 4 2 2 2 2 2 4 4 2 2 2 2 2 4 4 2 1 1 1 1 1 2 4 4 4 4 4 4 4 1 1 1 1 1 1 1 1 4 4 4 4 4 4 4 4 4 4 4 4 2 5 5 5 5 5 5 0 
0 5 5 5 7 7 6 2 4 4 4 2 4 4 4 4 4 4 4 4 4 4 4 4 4 2 10 10 10 4 4 4 4 4 4 4 4 4 2 1 1 1 1 1 2 4 4 4 4 4 4 4 1 1 1 1 1 1 1 1 4 4 4 4 4 4 4 4 4 4 4 4 2 5 5 5 5 5 5 0 
0 2 2 2 2 2 2 2 4 4 4 2 4 4 4 4 8 4 4 4 8 4 4 4 4 2 4 4 4 4 4 4 4 4 4 4 4 4 2 1 1 1 1 1 2 4 4 4 4 4 4 4 1 1 1 1 1 1 1 1 4 4 4 4 4 4 4 4 4 4 4 4 2 5 5 5 5 5 5 0 
0 5 5 5 7 7 6 2 4 4 4 2 4 4 4 9 9 9 9 9 9 9 4 4 4 2 4 4 4 4 4 4 4 4 4 4 4 4 2 1 1 1 1 1 2 4 4 4 4 4 4 4 2 1 1 1 1 1 1 2 4 4 4 4 2 2 2 2 2 2 2 2 2 2 2 5 5 2 2 0 
0 5 5 5 5 5 5 4 4 4 4 4 4 4 4 9 9 9 9 9 9 9 4 4 4 4 4 4 4 4 4 4 4 4 4 4 4 4 2 1 1 1 1 1 2 4 4 4 4 4 4 4 2 1 1 1 1 1 1 2 4 4 4 4 4 4 4 4 4 4 4 4 4 4 4 4 4 4 4 0 
0 5 5 5 5 5 5 4 4 4 4 4 4 4 4 9 9 9 9 9 9 9 4 4 4 4 4 4 4 4 4 4 4 4 4 4 4 4 2 1 1 1 1 1 2 4 4 4 4 4 4 4 2 1 1 1 1 1 1 2 4 4 4 4 4 4 4 4 4 4 4 4 4 4 4 4 4 4 4 0 
0 5 5 5 5 5 5 2 4 4 4 2 4 4 4 4 8 4 4 4 8 4 4 4 4 2 4 4 4 4 4 4 4 4 4 4 4 4 2 1 1 1 1 1 2 4 4 4 4 4 4 4 2 1 1 1 1 1 1 2 4 4 4 4 4 4 4 4 4 4 4 4 4 4 4 4 4 4 4 0 
0 18 5 5 5 12 12 2 4 4 4 2 4 4 4 4 4 4 4 4 4 4 4 4 4 2 4 4 4 4 4 4 4 4 4 4 4 4 2 1 1 1 1 1 2 2 2 2 2 2 2 2 2 1 1 1 1 1 1 2 4 4 4 4 4 4 4 4 4 4 4 4 4 4 4 4 4 4 4 0 
0 2 2 2 2 2 2 2 4 4 4 2 2 2 2 2 2 2 2 2 2 2 2 2 2 2 2 2 2 2 2 2 2 2 2 2 2 2 2 1 1 1 1 1 1 1 1 1 1 1 1 1 1 1 1 1 1 1 1 2 4 4 4 4 4 4 4 4 4 4 4 4 4 4 4 4 4 4 4 0 
0 5 5 5 5 6 6 2 1 1 1 1 1 1 1 1 1 1 1 1 1 1 1 1 1 1 1 1 1 1 1 1 1 1 1 1 1 1 1 1 1 1 1 1 1 1 1 1 1 1 1 1 1 1 1 1 1 1 1 2 2 2 2 2 2 2 2 2 2 2 2 2 2 2 2 2 2 2 2 0 
0 5 5 5 5 7 7 2 1 1 1 1 1 1 1 1 1 1 1 1 1 1 1 1 1 1 1 1 1 1 1 1 1 1 1 1 1 1 1 1 1 1 1 1 1 1 1 1 1 1 1 1 1 1 1 1 1 1 1 1 1 1 1 1 1 1 1 1 1 1 1 1 1 1 1 1 1 1 1 0 
0 5 5 5 5 7 7 2 1 1 1 1 1 1 1 1 1 1 1 1 1 1 1 1 1 1 1 1 1 1 1 1 1 1 1 1 1 1 1 1 1 1 1 1 1 1 1 1 1 1 1 1 1 1 1 1 1 1 1 1 1 1 1 1 1 1 1 1 1 1 1 1 1 1 1 1 1 1 1 0 
0 5 5 5 5 5 5 1 1 1 1 1 1 1 1 1 1 1 1 1 1 1 1 1 1 1 1 1 1 1 1 1 1 1 1 1 1 1 1 1 1 1 1 1 1 1 1 1 1 1 1 1 1 1 1 1 1 1 1 1 1 1 1 1 1 1 1 1 1 1 1 1 1 1 1 1 1 1 1 0 
0 5 5 5 5 5 5 1 1 1 1 1 1 1 1 1 1 1 1 1 1 1 1 1 1 1 1 1 1 1 1 1 1 1 1 1 1 1 1 1 1 1 1 1 1 1 1 1 1 1 1 1 1 1 1 1 1 1 1 1 1 1 1 1 1 1 1 1 1 1 1 1 1 1 1 1 1 1 1 0 
0 5 5 5 5 5 5 1 1 1 1 1 1 1 1 1 1 1 1 1 1 1 1 1 1 1 1 1 1 1 1 1 1 1 1 1 1 1 1 1 1 1 1 1 1 1 1 1 1 1 1 1 1 1 1 1 1 1 1 1 1 1 1 1 1 1 1 1 1 1 1 1 1 1 1 1 1 1 1 0 
0 5 5 5 5 5 5 1 1 1 1 1 1 1 1 1 1 1 1 1 1 1 1 1 1 1 1 1 1 1 1 1 1 1 1 1 1 1 1 1 1 1 1 1 1 1 1 1 1 1 1 1 1 1 1 1 1 1 1 1 1 1 1 1 1 1 1 1 1 1 1 1 1 1 1 1 1 1 1 0 
0 5 9 9 9 9 5 2 1 1 1 1 1 1 1 1 1 1 1 1 1 1 1 1 1 1 1 1 1 1 1 1 1 1 1 1 1 1 1 1 1 1 1 1 1 1 1 1 1 1 1 1 1 1 1 1 1 1 1 1 1 1 1 1 1 1 1 1 1 1 1 1 1 1 1 1 1 1 1 0 
0 8 9 9 9 9 8 2 1 1 1 1 1 1 1 1 1 1 1 1 1 1 1 1 1 1 1 1 1 1 1 1 1 1 1 1 1 1 1 1 1 1 1 1 1 1 1 1 2 2 2 2 2 2 2 2 2 2 2 2 2 2 2 2 2 2 2 2 2 4 4 4 2 2 2 2 2 2 2 0 
0 2 2 2 2 2 2 2 1 1 1 1 1 1 1 1 1 1 1 1 1 1 1 1 1 1 1 1 1 1 1 1 1 1 1 1 1 1 1 1 1 1 1 1 1 1 1 1 2 5 5 5 5 5 5 5 5 5 5 5 5 2 5 5 5 5 5 5 2 4 4 4 2 4 4 2 2 4 4 0 
0 1 1 1 1 1 1 1 1 1 1 1 1 1 1 1 1 1 1 1 1 1 1 1 1 1 1 1 1 1 1 1 1 1 1 1 1 1 1 1 1 1 1 1 1 1 1 1 2 5 5 5 5 5 5 5 5 5 5 5 5 2 5 5 5 5 5 5 2 4 4 4 2 4 4 2 2 4 4 0 
0 1 1 1 1 1 1 1 1 1 1 1 1 1 1 1 1 1 1 1 1 1 1 1 1 1 1 1 1 1 1 1 1 1 1 1 1 1 1 1 1 1 1 1 1 1 1 1 2 5 5 5 5 5 5 5 5 5 5 5 5 2 5 5 5 5 5 5 2 4 4 4 2 4 4 2 2 4 4 0 
0 1 1 1 1 1 1 1 1 1 1 1 1 1 1 1 1 1 1 1 1 1 1 1 1 1 1 1 1 1 1 1 1 1 1 1 1 1 1 1 1 1 1 1 1 1 1 1 2 5 5 5 5 5 5 5 5 5 5 5 5 2 5 5 5 5 5 5 2 4 4 4 2 4 4 4 4 4 4 0 
0 1 1 1 1 1 1 1 1 1 1 1 1 1 1 1 1 1 2 2 2 2 2 2 2 2 2 2 2 2 2 2 2 2 2 2 2 2 2 2 1 1 1 1 1 1 1 1 2 5 5 5 5 5 5 5 5 5 5 5 5 2 5 5 5 5 5 5 2 4 4 4 2 4 4 4 4 4 4 0 
0 1 1 1 1 1 1 1 1 1 1 1 1 1 1 1 1 1 2 4 4 4 4 4 4 4 4 4 4 4 4 4 4 4 4 8 4 8 4 2 1 1 1 1 1 1 1 1 2 5 5 5 5 5 5 5 5 5 5 5 5 2 5 5 5 5 5 5 2 4 4 4 2 4 4 4 4 4 4 0 
0 1 1 1 1 1 1 1 1 1 1 1 1 1 1 1 1 1 2 4 4 4 4 4 4 4 4 4 4 4 4 4 4 4 4 9 9 9 4 2 1 1 1 1 1 1 1 1 2 2 2 2 2 2 2 5 5 5 2 2 2 2 2 2 5 5 2 2 2 4 4 4 2 2 2 2 4 4 2 0 
0 1 1 1 1 2 2 2 2 2 2 2 2 2 2 1 1 1 2 4 4 4 4 4 4 4 4 4 4 4 4 4 4 4 4 9 9 9 4 2 1 1 1 1 1 1 1 1 2 5 5 5 5 5 2 4 4 4 4 4 4 4 4 4 4 4 4 4 2 4 4 4 2 4 4 4 4 4 4 0 
0 1 1 1 1 2 6 6 10 10 10 10 6 6 2 1 1 1 2 4 4 4 4 4 2 2 2 2 2 2 2 2 2 4 4 8 4 8 4 2 1 1 1 1 1 1 1 1 2 5 5 5 5 5 2 4 4 4 4 4 4 4 4 4 4 4 4 4 2 4 4 4 2 4 4 4 4 4 4 0 
0 1 1 1 1 2 7 7 5 5 5 5 7 7 2 1 1 1 2 4 4 4 4 4 2 6 6 10 10 10 5 5 2 4 4 4 4 4 4 2 1 1 1 1 1 1 1 1 2 5 5 5 5 5 2 4 4 4 4 4 4 4 4 4 4 4 4 4 2 4 4 4 2 4 4 4 4 4 4 0 
0 1 1 1 1 2 7 7 5 5 5 5 7 7 2 1 1 1 2 4 4 4 4 4 2 7 7 5 5 5 5 5 2 4 4 4 4 4 4 2 1 1 1 1 1 1 1 1 2 5 5 5 5 5 2 4 4 4 4 4 4 4 4 4 4 4 4 4 4 4 4 4 2 2 2 2 2 2 4 0 
0 1 1 1 1 1 5 5 5 5 5 5 5 5 2 1 1 1 2 2 1 1 2 2 2 7 7 5 5 5 5 5 2 4 4 4 4 4 4 2 1 1 1 1 1 1 1 1 2 5 5 5 5 5 2 4 4 4 4 4 4 4 4 4 4 4 4 4 4 4 4 4 4 4 4 4 4 4 4 0 
0 1 1 1 1 1 5 5 5 5 5 5 5 5 2 1 1 1 1 1 1 1 1 1 2 5 5 5 5 5 5 5 5 4 4 4 4 4 4 2 1 1 1 1 1 1 1 1 2 5 5 5 5 5 5 4 4 4 4 4 4 4 4 4 4 4 4 4 2 4 4 4 4 4 4 4 4 4 4 0 
0 1 3 3 1 2 5 5 5 5 5 5 5 5 2 1 1 1 1 1 1 1 1 1 2 5 5 5 5 5 5 5 5 4 4 4 4 4 4 2 1 1 3 3 3 3 1 1 2 5 5 5 5 5 5 4 4 4 4 4 4 4 4 4 4 4 4 4 2 4 4 4 4 4 2 4 4 4 4 0 
0 1 3 3 1 2 14 5 12 12 12 12 5 14 2 1 1 1 1 1 1 1 1 1 2 5 5 12 12 5 5 5 2 14 4 4 4 4 14 2 1 1 3 3 3 3 1 1 2 5 5 5 5 5 2 4 4 4 4 4 4 4 4 4 4 4 4 4 2 4 4 4 4 4 2 4 4 4 4 0 
0 0 0 0 0 0 0 0 0 0 0 0 0 0 0 0 0 0 0 0 0 0 0 0 0 0 0 0 0 0 0 0 0 0 0 0 0 0 0 0 0 0 0 0 0 0 0 0 0 0 0 0 0 0 0 0 0 0 0 0 0 0 0 0 0 0 0 0 0 0 0 0 0 0 0 0 0 0 0 0 
